OBJECTID,RELI,E_KOORD,E_ZENTER,N_KOORD,N_ZENTER,B20BM14,B20BM15,B20BM16,B20BM17,B20BM18,B20BM19,M_TOT,B20BW14,B20BW15,B20BW16,B20BW17,B20BW18,B20BW19,W_TOT,TOT
1,68772463,2687700,2687750,1246300,1246350,0,0,0,0,0,0,0,0,0,0,0,0,0,0,0
2,68032487,2680300,2680350,1248700,1248750,3,0,0,3,0,0,6,3,3,0,3,3,0,12,18
3,68302433,2683000,2683050,1243300,1243350,3,3,3,0,0,3,12,3,3,0,3,3,3,15,27
4,68302500,2683000,2683050,1250000,1250050,0,3,0,0,0,0,3,3,0,3,0,0,3,9,12
5,68312528,2683100,2683150,1252800,1252850,3,0,3,3,0,0,9,3,3,4,3,0,0,13,22
6,68312526,2683100,2683150,1252600,1252650,3,3,3,3,3,3,18,3,3,3,3,3,0,15,33
7,68312486,2683100,2683150,1248600,1248650,0,0,0,0,0,0,0,0,0,0,0,0,0,0,0
8,68312507,2683100,2683150,1250700,1250750,3,0,0,0,0,0,3,3,0,0,0,0,3,6,9
9,68322505,2683200,2683250,1250500,1250550,3,4,0,3,3,0,13,3,3,3,0,0,3,12,25
10,68322533,2683200,2683250,1253300,1253350,3,0,3,0,0,0,6,0,0,0,0,0,0,0,6
11,68332496,2683300,2683350,1249600,1249650,3,4,3,0,3,0,13,4,3,3,0,0,0,10,23
12,68332514,2683300,2683350,1251400,1251450,6,3,3,3,3,3,21,4,6,9,3,4,3,29,50
13,68332540,2683300,2683350,1254000,1254050,0,3,0,0,0,0,3,0,3,0,0,0,0,3,6
14,68342499,2683400,2683450,1249900,1249950,3,0,0,0,0,0,3,3,0,3,3,0,0,9,12
15,68342495,2683400,2683450,1249500,1249550,5,3,0,3,3,0,14,3,3,3,3,0,0,12,26
16,68342526,2683400,2683450,1252600,1252650,3,0,3,3,0,0,9,3,0,4,3,3,0,13,22
17,68342481,2683400,2683450,1248100,1248150,0,0,0,0,0,0,0,0,0,0,0,0,0,0,0
18,68342477,2683400,2683450,1247700,1247750,3,3,3,3,0,0,12,3,3,0,0,0,0,6,18
19,68352516,2683500,2683550,1251600,1251650,0,0,3,0,0,0,3,3,3,3,0,3,0,12,15
20,68352499,2683500,2683550,1249900,1249950,3,3,3,3,0,0,12,5,3,3,3,3,3,20,32
21,68352529,2683500,2683550,1252900,1252950,3,3,3,0,0,0,9,3,0,3,0,0,0,6,15
22,68362471,2683600,2683650,1247100,1247150,4,3,10,0,3,0,20,3,4,4,3,3,3,20,40
23,68362510,2683600,2683650,1251000,1251050,3,3,3,0,0,0,9,3,3,0,3,0,0,9,18
24,68362528,2683600,2683650,1252800,1252850,3,3,0,0,0,0,6,3,3,0,3,0,3,12,18
25,68362508,2683600,2683650,1250800,1250850,0,3,0,0,0,0,3,0,3,0,0,0,0,3,6
26,68362488,2683600,2683650,1248800,1248850,3,4,3,0,3,0,13,3,6,3,0,0,3,15,28
27,68362495,2683600,2683650,1249500,1249550,3,3,0,0,0,0,6,3,3,3,0,3,0,12,18
28,68372481,2683700,2683750,1248100,1248150,3,0,0,0,0,0,3,0,0,0,3,0,0,3,6
29,68372480,2683700,2683750,1248000,1248050,0,0,0,0,0,0,0,0,0,0,0,0,0,0,0
30,68372466,2683700,2683750,1246600,1246650,0,0,3,0,0,0,3,0,0,0,0,0,0,0,3
31,68382495,2683800,2683850,1249500,1249550,3,3,3,0,0,0,9,0,4,3,0,0,0,7,16
32,68382486,2683800,2683850,1248600,1248650,3,3,3,0,0,0,9,0,3,0,0,0,0,3,12
33,68382465,2683800,2683850,1246500,1246550,3,0,0,0,0,0,3,0,0,0,0,0,0,0,3
34,68382472,2683800,2683850,1247200,1247250,0,0,0,0,0,0,0,0,0,0,0,0,0,0,0
35,68392508,2683900,2683950,1250800,1250850,8,3,3,4,3,0,21,7,3,8,3,4,3,28,49
36,68392527,2683900,2683950,1252700,1252750,5,3,3,0,3,3,17,4,3,3,3,0,0,13,30
37,68392491,2683900,2683950,1249100,1249150,3,0,0,3,0,0,6,0,0,3,3,0,0,6,12
38,68392533,2683900,2683950,1253300,1253350,3,3,3,3,0,0,12,3,3,3,3,3,0,15,27
39,68392524,2683900,2683950,1252400,1252450,0,3,0,0,0,0,3,3,0,0,0,0,0,3,6
40,68412513,2684100,2684150,1251300,1251350,3,3,3,3,0,0,12,4,3,3,3,0,3,16,28
41,68412523,2684100,2684150,1252300,1252350,0,0,0,0,0,0,0,0,0,0,0,0,0,0,0
42,68422458,2684200,2684250,1245800,1245850,3,3,3,3,3,0,15,8,4,3,3,3,3,24,39
43,68422489,2684200,2684250,1248900,1248950,0,0,3,0,0,0,3,0,0,0,3,0,0,3,6
44,68432486,2684300,2684350,1248600,1248650,3,3,4,3,0,0,13,0,3,4,3,3,0,13,26
45,68442472,2684400,2684450,1247200,1247250,6,3,3,3,0,0,15,3,4,4,5,0,0,16,31
46,68442464,2684400,2684450,1246400,1246450,0,0,3,3,3,0,9,0,3,3,0,0,0,6,15
47,68452465,2684500,2684550,1246500,1246550,5,6,3,3,0,0,17,4,5,3,0,3,3,18,35
48,68452486,2684500,2684550,1248600,1248650,3,3,3,0,0,0,9,3,3,3,0,0,0,9,18
49,68452511,2684500,2684550,1251100,1251150,5,0,0,3,3,0,11,0,0,3,0,0,0,3,14
50,68452517,2684500,2684550,1251700,1251750,3,3,3,3,0,0,12,3,3,3,0,0,0,9,21
51,68462463,2684600,2684650,1246300,1246350,0,0,3,3,4,6,16,3,3,6,8,24,27,71,87
52,68462481,2684600,2684650,1248100,1248150,3,0,0,0,3,0,6,3,0,3,0,3,0,9,15
53,68462510,2684600,2684650,1251000,1251050,3,0,0,3,0,3,9,3,0,3,0,0,0,6,15
54,68462461,2684600,2684650,1246100,1246150,3,0,0,0,0,0,3,0,0,0,0,0,0,0,3
55,68462451,2684600,2684650,1245100,1245150,3,3,3,0,3,0,12,3,3,3,3,3,0,15,27
56,68462478,2684600,2684650,1247800,1247850,0,0,0,3,0,0,3,0,0,3,0,0,0,3,6
57,68472456,2684700,2684750,1245600,1245650,3,3,0,0,3,0,9,3,0,3,0,0,3,9,18
58,68472484,2684700,2684750,1248400,1248450,3,3,3,0,3,0,12,3,0,3,3,0,0,9,21
59,68482487,2684800,2684850,1248700,1248750,0,0,0,0,0,0,0,0,0,0,0,0,0,0,0
60,68482510,2684800,2684850,1251000,1251050,3,3,0,0,3,0,9,3,0,3,3,0,3,12,21
61,68492517,2684900,2684950,1251700,1251750,5,0,3,3,3,0,14,4,3,3,0,3,0,13,27
62,68492461,2684900,2684950,1246100,1246150,4,5,3,3,0,0,15,8,7,9,3,3,0,30,45
63,68492467,2684900,2684950,1246700,1246750,3,3,3,3,0,3,15,3,3,0,3,0,0,9,24
64,68492464,2684900,2684950,1246400,1246450,0,3,0,3,0,0,6,5,3,0,3,0,3,14,20
65,68492485,2684900,2684950,1248500,1248550,3,0,3,0,0,0,6,3,3,3,0,0,0,9,15
66,68502476,2685000,2685050,1247600,1247650,0,3,3,0,0,3,9,3,3,3,3,3,3,18,27
67,68502510,2685000,2685050,1251000,1251050,3,0,3,3,0,0,9,3,3,0,0,0,0,6,15
68,68502452,2685000,2685050,1245200,1245250,0,0,0,0,0,0,0,0,0,0,0,0,0,0,0
69,68502508,2685000,2685050,1250800,1250850,3,0,3,0,0,0,6,0,3,3,0,0,0,6,12
70,68512448,2685100,2685150,1244800,1244850,4,3,0,0,0,0,7,3,3,3,0,0,3,12,19
71,68512463,2685100,2685150,1246300,1246350,3,3,3,0,0,0,9,3,4,3,3,0,0,13,22
72,68522511,2685200,2685250,1251100,1251150,3,3,0,3,3,0,12,3,3,3,3,3,3,18,30
73,68522447,2685200,2685250,1244700,1244750,3,0,0,3,0,0,6,0,3,0,0,0,0,3,9
74,68532516,2685300,2685350,1251600,1251650,3,0,0,0,0,0,3,3,0,0,0,0,0,3,6
75,68532514,2685300,2685350,1251400,1251450,3,3,3,3,3,0,15,3,3,7,0,3,3,19,34
76,68532506,2685300,2685350,1250600,1250650,0,0,0,0,0,0,0,0,0,0,0,0,0,0,0
77,68552520,2685500,2685550,1252000,1252050,0,0,0,0,0,0,0,0,0,0,0,0,0,0,0
78,68552521,2685500,2685550,1252100,1252150,0,0,3,0,0,0,3,0,3,0,0,0,0,3,6
79,68552456,2685500,2685550,1245600,1245650,3,3,0,0,0,0,6,0,3,3,0,0,0,6,12
80,68562456,2685600,2685650,1245600,1245650,6,3,3,3,3,0,18,7,3,0,3,0,3,16,34
81,68562509,2685600,2685650,1250900,1250950,3,3,3,0,0,0,9,3,0,0,0,0,0,3,12
82,68562475,2685600,2685650,1247500,1247550,0,0,0,0,3,0,3,0,0,0,0,0,0,0,3
83,68582511,2685800,2685850,1251100,1251150,4,0,3,0,0,3,10,4,3,3,4,0,0,14,24
84,68582474,2685800,2685850,1247400,1247450,0,3,0,3,0,0,6,0,3,3,3,0,0,9,15
85,68582458,2685800,2685850,1245800,1245850,3,0,0,0,0,0,3,0,0,0,0,0,0,0,3
86,68592489,2685900,2685950,1248900,1248950,3,3,3,3,3,0,15,0,3,3,3,3,0,12,27
87,68612459,2686100,2686150,1245900,1245950,3,3,3,3,3,0,15,3,3,3,3,0,0,12,27
88,68612448,2686100,2686150,1244800,1244850,0,0,3,0,0,0,3,3,0,0,0,0,0,3,6
89,68612455,2686100,2686150,1245500,1245550,0,0,0,0,0,0,0,0,0,0,0,0,0,0,0
90,68632456,2686300,2686350,1245600,1245650,4,3,3,3,0,0,13,5,3,3,3,0,0,14,27
91,68642507,2686400,2686450,1250700,1250750,4,0,3,3,0,0,10,3,3,3,3,3,3,18,28
92,68652451,2686500,2686550,1245100,1245150,3,3,5,0,0,0,11,6,3,3,3,0,0,15,26
93,68662502,2686600,2686650,1250200,1250250,0,0,0,0,0,0,0,0,3,0,0,0,0,3,3
94,68682487,2686800,2686850,1248700,1248750,0,3,0,0,0,0,3,0,0,3,0,0,0,3,6
95,68682511,2686800,2686850,1251100,1251150,3,3,0,0,0,0,6,0,0,3,0,3,0,6,12
96,68692506,2686900,2686950,1250600,1250650,4,3,3,0,3,0,13,4,3,3,0,5,0,15,28
97,68702466,2687000,2687050,1246600,1246650,0,0,0,0,0,0,0,0,0,0,0,0,3,3,3
98,68702485,2687000,2687050,1248500,1248550,0,0,0,3,0,0,3,0,0,0,0,0,0,0,3
99,68712464,2687100,2687150,1246400,1246450,0,0,3,0,0,3,6,0,3,0,0,0,3,6,12
100,68712458,2687100,2687150,1245800,1245850,0,0,0,0,0,0,0,0,3,0,0,0,0,3,3
101,68742454,2687400,2687450,1245400,1245450,0,3,4,4,0,0,11,3,3,7,4,0,0,17,28
102,68752454,2687500,2687550,1245400,1245450,3,0,8,4,3,0,18,4,5,8,3,3,3,26,44
103,68762462,2687600,2687650,1246200,1246250,0,0,0,0,0,0,0,3,0,0,3,0,0,6,6
104,67782492,2677800,2677850,1249200,1249250,3,3,0,3,3,3,15,3,3,4,3,3,3,19,34
105,67792491,2677900,2677950,1249100,1249150,0,3,3,0,3,0,9,3,0,6,4,3,3,19,28
106,67812487,2678100,2678150,1248700,1248750,0,0,0,0,0,0,0,3,0,0,3,0,0,6,6
107,67822494,2678200,2678250,1249400,1249450,3,3,4,0,0,0,10,4,4,3,0,0,0,11,21
108,67842491,2678400,2678450,1249100,1249150,3,3,3,3,3,0,15,3,4,3,5,0,0,15,30
109,67852518,2678500,2678550,1251800,1251850,3,0,3,3,3,3,15,3,3,3,0,0,3,12,27
110,67852512,2678500,2678550,1251200,1251250,0,0,0,3,3,0,6,4,0,0,3,3,0,10,16
111,67852478,2678500,2678550,1247800,1247850,0,0,0,3,0,0,3,0,0,0,3,0,0,3,6
112,67862516,2678600,2678650,1251600,1251650,0,3,0,0,3,0,6,3,3,0,3,0,0,9,15
113,67872478,2678700,2678750,1247800,1247850,4,3,3,0,3,0,13,3,3,3,3,3,0,15,28
114,67872515,2678700,2678750,1251500,1251550,0,4,3,3,3,3,16,6,9,11,9,7,3,45,61
115,67872481,2678700,2678750,1248100,1248150,0,0,0,0,0,0,0,0,0,0,0,0,0,0,0
116,67882493,2678800,2678850,1249300,1249350,0,3,0,0,0,0,3,0,3,0,3,0,0,6,9
117,67882514,2678800,2678850,1251400,1251450,3,0,3,3,3,0,12,4,3,0,3,3,0,13,25
118,67882486,2678800,2678850,1248600,1248650,3,0,3,0,0,0,6,3,3,3,0,3,0,12,18
119,67892497,2678900,2678950,1249700,1249750,3,3,0,0,0,0,6,0,0,0,0,0,0,0,6
120,67892472,2678900,2678950,1247200,1247250,3,0,0,0,0,0,3,0,0,0,0,0,0,0,3
121,67902485,2679000,2679050,1248500,1248550,4,3,3,3,0,0,13,3,3,0,3,3,3,15,28
122,67902489,2679000,2679050,1248900,1248950,3,3,0,0,3,0,9,0,3,3,3,3,0,12,21
123,67912474,2679100,2679150,1247400,1247450,0,0,3,3,0,0,6,0,3,3,3,0,0,9,15
124,67912489,2679100,2679150,1248900,1248950,3,0,0,3,3,0,9,3,3,3,4,0,3,16,25
125,67922510,2679200,2679250,1251000,1251050,0,3,3,3,0,0,9,0,3,0,3,0,0,6,15
126,67932510,2679300,2679350,1251000,1251050,0,0,0,0,0,0,0,4,0,0,0,0,0,4,4
127,67932488,2679300,2679350,1248800,1248850,3,3,0,0,0,0,6,3,3,3,3,0,0,12,18
128,67942473,2679400,2679450,1247300,1247350,0,0,0,3,3,3,9,4,3,3,3,0,5,18,27
129,67942496,2679400,2679450,1249600,1249650,0,0,0,0,0,0,0,0,0,0,0,0,0,0,0
130,67952505,2679500,2679550,1250500,1250550,3,3,3,3,3,0,15,6,3,3,3,3,0,18,33
131,67962474,2679600,2679650,1247400,1247450,3,4,3,0,0,3,13,3,9,3,8,9,3,35,48
132,67982471,2679800,2679850,1247100,1247150,3,3,0,0,3,0,9,0,4,3,3,3,3,16,25
133,67982469,2679800,2679850,1246900,1246950,3,3,3,3,3,0,15,3,3,3,3,3,3,18,33
134,67982487,2679800,2679850,1248700,1248750,0,0,3,3,0,0,6,0,3,0,0,0,0,3,9
135,67992484,2679900,2679950,1248400,1248450,5,3,3,3,0,0,14,7,9,3,3,0,0,22,36
136,67992509,2679900,2679950,1250900,1250950,3,4,4,3,3,5,22,3,4,8,4,7,13,39,61
137,67992533,2679900,2679950,1253300,1253350,0,3,3,3,0,0,9,3,0,0,0,3,0,6,15
138,68002463,2680000,2680050,1246300,1246350,3,3,3,3,0,3,15,3,0,0,3,3,3,12,27
139,68002485,2680000,2680050,1248500,1248550,3,3,3,0,3,0,12,3,6,3,3,3,0,18,30
140,68002486,2680000,2680050,1248600,1248650,3,3,0,3,0,0,9,3,3,0,0,3,0,9,18
141,68002504,2680000,2680050,1250400,1250450,0,3,3,3,3,0,12,0,3,3,0,0,0,6,18
142,68002508,2680000,2680050,1250800,1250850,0,3,3,0,3,0,9,3,3,0,3,3,3,15,24
143,68012526,2680100,2680150,1252600,1252650,4,3,3,3,3,0,16,3,3,3,3,3,3,18,34
144,68032471,2680300,2680350,1247100,1247150,3,3,3,3,3,0,15,3,3,6,7,3,3,25,40
145,68042508,2680400,2680450,1250800,1250850,3,3,0,0,0,0,6,4,0,0,0,3,0,7,13
146,68042473,2680400,2680450,1247300,1247350,0,3,0,0,0,0,3,3,3,3,0,3,0,12,15
147,68052462,2680500,2680550,1246200,1246250,3,3,0,0,0,0,6,0,3,0,0,0,0,3,9
148,68052530,2680500,2680550,1253000,1253050,0,0,4,3,0,3,10,0,3,4,3,0,0,10,20
149,68052521,2680500,2680550,1252100,1252150,3,0,3,3,0,0,9,0,0,0,3,3,0,6,15
150,68052518,2680500,2680550,1251800,1251850,0,0,0,0,3,0,3,0,0,0,0,0,3,3,6
151,68072504,2680700,2680750,1250400,1250450,7,8,4,3,3,3,28,9,4,5,6,3,3,30,58
152,68072503,2680700,2680750,1250300,1250350,0,3,3,0,3,0,9,3,3,3,3,0,3,15,24
153,68072457,2680700,2680750,1245700,1245750,3,3,0,0,0,0,6,0,0,0,0,0,0,0,6
154,68072520,2680700,2680750,1252000,1252050,3,7,3,3,3,0,19,3,6,3,4,3,3,22,41
155,68072502,2680700,2680750,1250200,1250250,3,3,0,0,0,0,6,3,0,0,3,0,0,6,12
156,68072466,2680700,2680750,1246600,1246650,3,0,3,3,3,3,15,0,3,3,0,0,0,6,21
157,68072480,2680700,2680750,1248000,1248050,3,5,3,3,0,0,14,3,3,3,3,3,3,18,32
158,68072532,2680700,2680750,1253200,1253250,0,0,0,0,0,0,0,3,0,0,3,0,0,6,6
159,68082456,2680800,2680850,1245600,1245650,3,3,0,0,3,0,9,3,0,0,3,0,0,6,15
160,68082479,2680800,2680850,1247900,1247950,3,4,5,3,0,0,15,5,7,3,9,3,0,27,42
161,68092533,2680900,2680950,1253300,1253350,0,0,0,0,3,0,3,0,0,0,3,0,0,3,6
162,68092452,2680900,2680950,1245200,1245250,4,3,3,0,0,3,13,6,3,3,3,3,0,18,31
163,68092471,2680900,2680950,1247100,1247150,0,3,0,0,0,0,3,0,3,3,3,0,3,12,15
164,68092521,2680900,2680950,1252100,1252150,3,3,5,5,3,3,22,8,7,8,11,3,4,41,63
165,68092528,2680900,2680950,1252800,1252850,3,0,3,0,0,0,6,0,0,3,0,3,3,9,15
166,68102455,2681000,2681050,1245500,1245550,3,4,0,3,0,0,10,6,3,0,3,0,0,12,22
167,68102481,2681000,2681050,1248100,1248150,3,3,3,0,3,3,15,3,3,3,3,3,3,18,33
168,68102420,2681000,2681050,1242000,1242050,3,4,4,3,0,3,17,8,10,3,3,3,3,30,47
169,68112518,2681100,2681150,1251800,1251850,3,3,5,3,0,0,14,4,6,5,4,3,3,25,39
170,68112455,2681100,2681150,1245500,1245550,3,3,3,3,3,3,18,3,3,6,5,3,3,23,41
171,68112499,2681100,2681150,1249900,1249950,0,3,3,3,0,0,9,0,3,6,0,3,0,12,21
172,68112474,2681100,2681150,1247400,1247450,5,4,7,3,3,3,25,10,6,3,4,4,3,30,55
173,68112486,2681100,2681150,1248600,1248650,0,0,0,0,0,0,0,0,0,0,0,0,0,0,0
174,68112490,2681100,2681150,1249000,1249050,5,3,3,3,0,0,14,5,3,3,3,0,0,14,28
175,68112428,2681100,2681150,1242800,1242850,0,3,0,0,3,0,6,3,0,0,3,0,0,6,12
176,68122473,2681200,2681250,1247300,1247350,8,3,0,3,3,0,17,6,3,3,3,0,3,18,35
177,68122475,2681200,2681250,1247500,1247550,4,3,4,0,3,0,14,7,3,3,3,0,0,16,30
178,68122501,2681200,2681250,1250100,1250150,3,0,0,0,0,3,6,0,3,0,3,0,0,6,12
179,68132503,2681300,2681350,1250300,1250350,3,3,3,5,3,4,21,3,4,9,12,25,46,99,120
180,68142473,2681400,2681450,1247300,1247350,4,3,3,3,0,0,13,5,3,3,3,5,3,22,35
181,68142461,2681400,2681450,1246100,1246150,3,0,0,0,0,0,3,3,0,0,0,0,0,3,6
182,68142471,2681400,2681450,1247100,1247150,6,3,0,3,0,0,12,8,3,3,3,3,3,23,35
183,68142500,2681400,2681450,1250000,1250050,7,3,3,3,3,0,19,5,3,5,0,4,3,20,39
184,68142509,2681400,2681450,1250900,1250950,0,0,0,0,0,0,0,0,0,0,0,0,0,0,0
185,68142474,2681400,2681450,1247400,1247450,0,3,0,3,3,0,9,3,3,0,3,3,0,12,21
186,68152483,2681500,2681550,1248300,1248350,3,3,3,3,0,0,12,3,0,3,3,0,0,9,21
187,68152472,2681500,2681550,1247200,1247250,3,0,3,0,3,0,9,3,5,3,3,0,3,17,26
188,68152434,2681500,2681550,1243400,1243450,3,3,0,3,3,0,12,3,3,3,3,3,0,15,27
189,68162473,2681600,2681650,1247300,1247350,4,3,3,0,0,0,10,3,3,0,0,0,3,9,19
190,68162501,2681600,2681650,1250100,1250150,0,0,0,0,0,0,0,3,3,3,3,3,0,15,15
191,68162500,2681600,2681650,1250000,1250050,3,3,0,3,0,0,9,0,3,3,0,0,0,6,15
192,68162488,2681600,2681650,1248800,1248850,0,0,0,0,0,0,0,0,0,0,0,0,0,0,0
193,68172469,2681700,2681750,1246900,1246950,3,5,5,3,4,0,20,3,3,3,3,3,0,15,35
194,68172437,2681700,2681750,1243700,1243750,3,0,0,0,0,0,3,3,3,3,3,3,3,18,21
195,68182468,2681800,2681850,1246800,1246850,6,3,0,3,3,0,15,4,3,3,3,3,0,16,31
196,68182476,2681800,2681850,1247600,1247650,3,0,0,3,3,0,9,0,0,3,0,0,0,3,12
197,68182473,2681800,2681850,1247300,1247350,3,3,0,0,0,0,6,3,3,0,0,3,0,9,15
198,68192490,2681900,2681950,1249000,1249050,3,0,0,0,0,0,3,0,0,0,0,0,0,0,3
199,68192503,2681900,2681950,1250300,1250350,3,3,0,0,0,0,6,3,0,0,0,0,0,3,9
200,68192435,2681900,2681950,1243500,1243550,0,0,0,3,0,0,3,0,0,0,3,0,0,3,6
201,68202502,2682000,2682050,1250200,1250250,0,3,0,0,0,0,3,0,0,3,0,0,0,3,6
202,68202474,2682000,2682050,1247400,1247450,6,3,3,0,0,0,12,3,3,0,3,0,0,9,21
203,68202476,2682000,2682050,1247600,1247650,0,3,0,3,0,0,6,0,0,3,3,0,0,6,12
204,68202498,2682000,2682050,1249800,1249850,3,0,0,3,0,0,6,0,3,3,0,0,3,9,15
205,68202489,2682000,2682050,1248900,1248950,4,4,3,3,3,0,17,3,3,3,3,3,3,18,35
206,68202439,2682000,2682050,1243900,1243950,3,3,0,0,0,0,6,3,3,0,3,0,0,9,15
207,68202433,2682000,2682050,1243300,1243350,3,0,3,0,0,0,6,0,0,3,0,0,0,3,9
208,68212436,2682100,2682150,1243600,1243650,0,3,3,3,0,0,9,3,3,3,3,0,0,12,21
209,68212489,2682100,2682150,1248900,1248950,6,3,4,0,0,0,13,4,4,3,3,3,0,17,30
210,68212517,2682100,2682150,1251700,1251750,3,3,0,0,0,0,6,3,0,0,3,3,0,9,15
211,68222517,2682200,2682250,1251700,1251750,0,0,0,0,0,0,0,3,0,0,0,0,0,3,3
212,68222487,2682200,2682250,1248700,1248750,6,3,4,3,0,0,16,6,6,3,3,0,0,18,34
213,68222495,2682200,2682250,1249500,1249550,3,3,5,0,0,3,14,6,5,4,3,0,0,18,32
214,68222492,2682200,2682250,1249200,1249250,0,3,0,0,0,0,3,3,0,0,0,0,0,3,6
215,68222450,2682200,2682250,1245000,1245050,3,3,3,0,0,0,9,0,3,3,0,3,0,9,18
216,68222446,2682200,2682250,1244600,1244650,3,0,0,0,0,0,3,3,0,0,0,0,0,3,6
217,68232445,2682300,2682350,1244500,1244550,3,0,3,0,0,3,9,3,3,0,0,0,0,6,15
218,68232487,2682300,2682350,1248700,1248750,5,4,0,0,3,0,12,3,0,3,0,3,0,9,21
219,68232433,2682300,2682350,1243300,1243350,5,3,0,3,3,3,17,4,6,3,3,5,3,24,41
220,68232518,2682300,2682350,1251800,1251850,3,6,4,4,0,0,17,8,5,4,3,3,3,26,43
221,68232499,2682300,2682350,1249900,1249950,3,4,4,3,3,0,17,4,6,4,3,3,0,20,37
222,68232429,2682300,2682350,1242900,1242950,3,0,3,0,0,0,6,3,3,0,0,0,0,6,12
223,68232453,2682300,2682350,1245300,1245350,3,3,0,3,3,3,15,3,3,3,3,3,3,18,33
224,68232460,2682300,2682350,1246000,1246050,0,0,0,0,0,0,0,0,0,0,0,0,0,0,0
225,68232521,2682300,2682350,1252100,1252150,0,3,4,3,0,0,10,0,3,6,3,3,3,18,28
226,68232464,2682300,2682350,1246400,1246450,0,3,3,0,0,0,6,0,3,3,0,0,0,6,12
227,68232466,2682300,2682350,1246600,1246650,0,3,0,3,0,0,6,0,0,3,0,0,0,3,9
228,68242464,2682400,2682450,1246400,1246450,3,3,3,3,3,5,20,3,3,3,4,15,16,44,64
229,68242448,2682400,2682450,1244800,1244850,0,0,0,0,0,0,0,0,0,0,0,0,0,0,0
230,68242496,2682400,2682450,1249600,1249650,4,6,3,3,3,0,19,4,3,0,3,3,0,13,32
231,68242478,2682400,2682450,1247800,1247850,0,0,0,0,0,0,0,0,0,0,0,0,0,0,0
232,68242469,2682400,2682450,1246900,1246950,0,0,3,0,0,0,3,3,0,3,0,0,0,6,9
233,68252454,2682500,2682550,1245400,1245450,3,0,3,0,0,0,6,3,3,0,0,0,0,6,12
234,68252481,2682500,2682550,1248100,1248150,3,3,3,0,0,0,9,3,3,3,3,0,0,12,21
235,68252448,2682500,2682550,1244800,1244850,0,0,0,0,0,0,0,3,0,0,0,0,0,3,3
236,68262498,2682600,2682650,1249800,1249850,3,3,0,0,0,0,6,3,3,3,0,3,0,12,18
237,68262471,2682600,2682650,1247100,1247150,5,5,7,3,3,0,23,4,3,3,3,3,3,19,42
238,68262435,2682600,2682650,1243500,1243550,3,3,3,0,0,0,9,5,4,3,3,0,5,20,29
239,68262515,2682600,2682650,1251500,1251550,3,4,3,3,3,0,16,6,3,3,0,0,3,15,31
240,68262495,2682600,2682650,1249500,1249550,3,3,3,0,0,0,9,3,3,3,3,3,0,15,24
241,68262444,2682600,2682650,1244400,1244450,0,3,3,3,0,0,9,3,3,3,3,3,0,15,24
242,68272485,2682700,2682750,1248500,1248550,0,0,0,0,0,0,0,0,0,0,0,0,0,0,0
243,68272433,2682700,2682750,1243300,1243350,3,0,0,3,0,0,6,4,3,3,3,0,0,13,19
244,68272501,2682700,2682750,1250100,1250150,3,3,3,3,0,0,12,6,4,3,3,3,3,22,34
245,68272468,2682700,2682750,1246800,1246850,3,3,0,0,0,0,6,3,3,3,0,0,0,9,15
246,68272444,2682700,2682750,1244400,1244450,0,3,0,0,3,0,6,0,3,0,3,3,0,9,15
247,68282534,2682800,2682850,1253400,1253450,3,0,0,0,0,0,3,3,3,0,0,0,0,6,9
248,68282483,2682800,2682850,1248300,1248350,3,3,3,0,3,0,12,3,3,0,3,0,0,9,21
249,68282521,2682800,2682850,1252100,1252150,0,0,0,0,0,0,0,0,0,0,0,0,0,0,0
250,68282476,2682800,2682850,1247600,1247650,3,0,0,0,0,0,3,0,0,3,0,0,0,3,6
251,68292502,2682900,2682950,1250200,1250250,4,4,4,3,3,3,21,3,3,3,3,3,3,18,39
252,68292484,2682900,2682950,1248400,1248450,0,0,3,3,0,0,6,3,0,3,0,0,0,6,12
253,68292536,2682900,2682950,1253600,1253650,0,3,3,3,0,0,9,3,0,3,0,0,0,6,15
254,68302429,2683000,2683050,1242900,1242950,0,0,0,0,3,0,3,0,0,0,0,0,0,0,3
255,68302522,2683000,2683050,1252200,1252250,0,0,0,0,0,0,0,3,3,0,0,0,0,6,6
256,68302499,2683000,2683050,1249900,1249950,3,0,3,0,0,0,6,5,3,0,0,3,0,11,17
257,68302431,2683000,2683050,1243100,1243150,0,0,0,0,0,0,0,0,0,0,0,0,0,0,0
258,68312529,2683100,2683150,1252900,1252950,3,3,0,3,3,0,12,3,3,3,3,0,3,15,27
259,68312503,2683100,2683150,1250300,1250350,3,0,0,0,0,0,3,0,3,0,3,0,3,9,12
260,68312478,2683100,2683150,1247800,1247850,0,0,0,0,0,0,0,0,0,0,0,0,0,0,0
261,68322510,2683200,2683250,1251000,1251050,3,3,3,0,0,0,9,5,5,5,3,3,3,24,33
262,68322501,2683200,2683250,1250100,1250150,0,0,0,0,0,0,0,0,0,0,0,0,0,0,0
263,68322514,2683200,2683250,1251400,1251450,3,3,3,3,0,3,15,0,3,3,0,3,0,9,24
264,68322488,2683200,2683250,1248800,1248850,0,0,0,0,0,0,0,0,0,3,0,0,0,3,3
265,68332509,2683300,2683350,1250900,1250950,3,3,3,3,3,3,18,4,3,3,3,0,0,13,31
266,68332505,2683300,2683350,1250500,1250550,3,3,0,0,3,0,9,0,5,0,3,3,3,14,23
267,68332499,2683300,2683350,1249900,1249950,3,3,3,3,0,0,12,3,3,3,3,3,0,15,27
268,68332528,2683300,2683350,1252800,1252850,0,0,0,0,0,0,0,3,3,0,0,0,0,6,6
269,68342493,2683400,2683450,1249300,1249350,0,3,3,0,0,3,9,5,3,3,3,0,0,14,23
270,68342512,2683400,2683450,1251200,1251250,3,3,0,0,0,0,6,0,0,0,0,0,0,0,6
271,68342494,2683400,2683450,1249400,1249450,4,3,3,3,3,0,16,4,3,3,3,0,3,16,32
272,68342490,2683400,2683450,1249000,1249050,3,3,4,3,3,0,16,3,3,4,3,3,0,16,32
273,68352489,2683500,2683550,1248900,1248950,6,4,4,3,3,0,20,5,3,5,3,0,0,16,36
274,68352493,2683500,2683550,1249300,1249350,4,7,4,3,0,0,18,7,4,3,0,0,0,14,32
275,68352528,2683500,2683550,1252800,1252850,0,0,0,0,0,0,0,0,0,0,0,0,0,0,0
276,68362537,2683600,2683650,1253700,1253750,3,0,0,0,0,0,3,3,0,3,0,0,0,6,9
277,68362494,2683600,2683650,1249400,1249450,3,3,3,0,0,0,9,3,3,3,3,3,0,15,24
278,68362522,2683600,2683650,1252200,1252250,0,3,0,0,3,3,9,0,0,3,0,0,0,3,12
279,68362479,2683600,2683650,1247900,1247950,3,0,3,3,4,3,16,0,0,3,7,5,15,30,46
280,68372470,2683700,2683750,1247000,1247050,0,3,0,0,0,0,3,0,0,0,0,0,0,0,3
281,68372522,2683700,2683750,1252200,1252250,3,0,0,0,0,0,3,3,3,0,0,0,0,6,9
282,68372465,2683700,2683750,1246500,1246550,0,3,0,3,0,0,6,0,3,0,3,3,0,9,15
283,68372492,2683700,2683750,1249200,1249250,0,3,3,3,0,3,12,3,0,3,0,0,0,6,18
284,68382517,2683800,2683850,1251700,1251750,0,0,0,0,0,0,0,0,3,3,0,0,0,6,6
285,68382534,2683800,2683850,1253400,1253450,3,6,0,3,0,0,12,5,3,5,3,0,0,16,28
286,68382530,2683800,2683850,1253000,1253050,4,4,6,3,3,0,20,3,6,11,10,10,9,49,69
287,68392514,2683900,2683950,1251400,1251450,3,0,3,0,0,0,6,0,3,3,0,0,0,6,12
288,68392530,2683900,2683950,1253000,1253050,3,3,3,0,0,0,9,3,3,0,0,0,0,6,15
289,68392472,2683900,2683950,1247200,1247250,0,3,3,3,0,0,9,0,0,3,0,3,3,9,18
290,68392482,2683900,2683950,1248200,1248250,0,3,3,0,0,0,6,3,3,5,0,0,0,11,17
291,68392512,2683900,2683950,1251200,1251250,3,0,3,0,0,0,6,3,0,3,3,0,0,9,15
292,68402463,2684000,2684050,1246300,1246350,4,3,3,3,0,0,13,3,3,3,3,3,3,18,31
293,68402534,2684000,2684050,1253400,1253450,3,3,3,4,3,3,19,3,3,4,5,3,3,21,40
294,68402465,2684000,2684050,1246500,1246550,4,4,3,3,3,0,17,6,3,0,0,0,0,9,26
295,68402488,2684000,2684050,1248800,1248850,3,0,3,3,3,0,12,3,3,4,3,0,0,13,25
296,68402532,2684000,2684050,1253200,1253250,0,3,3,3,3,0,12,4,3,5,3,3,3,21,33
297,68402458,2684000,2684050,1245800,1245850,3,0,0,0,0,0,3,0,3,3,0,0,0,6,9
298,68412508,2684100,2684150,1250800,1250850,3,6,3,3,3,0,18,3,3,3,3,3,0,15,33
299,68412512,2684100,2684150,1251200,1251250,3,0,0,0,0,0,3,0,0,0,0,0,0,0,3
300,68412474,2684100,2684150,1247400,1247450,0,3,0,3,0,0,6,3,3,3,3,0,0,12,18
301,68412522,2684100,2684150,1252200,1252250,0,0,0,0,0,0,0,3,0,0,0,0,0,3,3
302,68422510,2684200,2684250,1251000,1251050,3,0,3,0,0,0,6,3,3,0,3,0,0,9,15
303,68422466,2684200,2684250,1246600,1246650,3,3,3,3,0,0,12,3,3,3,3,0,0,12,24
304,68422505,2684200,2684250,1250500,1250550,3,0,3,0,0,0,6,3,0,3,0,0,0,6,12
305,68422480,2684200,2684250,1248000,1248050,0,0,0,0,0,0,0,3,0,3,3,0,0,9,9
306,68432477,2684300,2684350,1247700,1247750,3,3,3,3,3,0,15,0,3,3,0,3,3,12,27
307,68432514,2684300,2684350,1251400,1251450,3,3,3,3,0,0,12,0,3,5,3,3,0,14,26
308,68442476,2684400,2684450,1247600,1247650,0,3,0,3,0,0,6,0,0,3,0,0,0,3,9
309,68442468,2684400,2684450,1246800,1246850,3,4,3,3,3,0,16,4,5,3,3,3,3,21,37
310,68442482,2684400,2684450,1248200,1248250,3,3,3,3,3,3,18,3,4,6,5,3,3,24,42
311,68452471,2684500,2684550,1247100,1247150,3,3,3,3,0,0,12,4,3,0,3,3,3,16,28
312,68452520,2684500,2684550,1252000,1252050,6,3,3,0,0,0,12,7,3,0,3,0,3,16,28
313,68452464,2684500,2684550,1246400,1246450,3,3,4,0,3,0,13,0,4,3,3,3,0,13,26
314,68452512,2684500,2684550,1251200,1251250,0,0,0,3,0,0,3,0,3,3,3,0,0,9,12
315,68452484,2684500,2684550,1248400,1248450,3,0,0,0,0,0,3,0,3,3,0,0,0,6,9
316,68462483,2684600,2684650,1248300,1248350,3,3,0,3,0,0,9,3,3,3,0,3,0,12,21
317,68462488,2684600,2684650,1248800,1248850,3,3,0,0,3,0,9,3,3,3,3,3,0,15,24
318,68462516,2684600,2684650,1251600,1251650,3,6,3,3,3,0,18,3,7,4,0,3,0,17,35
319,68472471,2684700,2684750,1247100,1247150,3,3,0,0,0,0,6,3,3,3,3,3,3,18,24
320,68482471,2684800,2684850,1247100,1247150,3,3,3,3,0,0,12,3,3,3,3,3,3,18,30
321,68482485,2684800,2684850,1248500,1248550,3,3,0,3,0,0,9,3,3,3,3,0,0,12,21
322,68482512,2684800,2684850,1251200,1251250,4,3,0,0,0,0,7,3,3,3,3,3,4,19,26
323,68482474,2684800,2684850,1247400,1247450,0,3,3,3,0,0,9,3,0,6,0,0,3,12,21
324,68482481,2684800,2684850,1248100,1248150,3,3,0,0,0,0,6,3,0,0,0,0,0,3,9
325,68492465,2684900,2684950,1246500,1246550,3,0,3,0,0,0,6,0,0,3,3,3,0,9,15
326,68492466,2684900,2684950,1246600,1246650,4,3,3,3,3,3,19,3,3,3,4,4,0,17,36
327,68492474,2684900,2684950,1247400,1247450,3,0,0,0,0,0,3,0,0,0,0,0,0,0,3
328,68492450,2684900,2684950,1245000,1245050,3,3,3,0,0,0,9,3,3,3,0,3,3,15,24
329,68502471,2685000,2685050,1247100,1247150,0,3,3,3,0,0,9,3,0,3,0,0,0,6,15
330,68502448,2685000,2685050,1244800,1244850,3,3,3,3,3,0,15,0,4,0,0,0,0,4,19
331,68502474,2685000,2685050,1247400,1247450,3,3,0,3,0,0,9,3,3,3,3,0,0,12,21
332,68502469,2685000,2685050,1246900,1246950,3,0,3,0,0,0,6,3,3,3,3,0,0,12,18
333,68502461,2685000,2685050,1246100,1246150,3,6,3,3,0,0,15,3,3,5,3,3,3,20,35
334,68502454,2685000,2685050,1245400,1245450,0,0,0,0,0,0,0,0,3,3,0,0,0,6,6
335,68502512,2685000,2685050,1251200,1251250,3,3,0,0,3,0,9,3,3,3,3,0,3,15,24
336,68502446,2685000,2685050,1244600,1244650,0,3,0,0,0,0,3,0,0,0,0,0,0,0,3
337,68512460,2685100,2685150,1246000,1246050,3,3,3,3,0,0,12,3,3,3,3,3,3,18,30
338,68512461,2685100,2685150,1246100,1246150,5,3,3,3,3,3,20,3,3,5,11,5,7,34,54
339,68522479,2685200,2685250,1247900,1247950,3,3,0,0,0,3,9,3,3,3,3,0,3,15,24
340,68522480,2685200,2685250,1248000,1248050,0,3,0,0,0,0,3,0,0,3,3,0,0,6,9
341,68522518,2685200,2685250,1251800,1251850,0,0,0,0,3,0,3,0,0,0,3,0,0,3,6
342,68532467,2685300,2685350,1246700,1246750,0,3,0,0,0,0,3,3,0,0,3,0,0,6,9
343,68532511,2685300,2685350,1251100,1251150,3,3,3,3,0,0,12,3,0,0,3,3,0,9,21
344,68532510,2685300,2685350,1251000,1251050,3,0,3,3,0,0,9,3,0,3,0,0,3,9,18
345,68542511,2685400,2685450,1251100,1251150,4,0,0,3,3,3,13,3,3,3,5,3,3,20,33
346,68542469,2685400,2685450,1246900,1246950,0,0,3,3,0,3,9,0,3,0,0,3,0,6,15
347,68552460,2685500,2685550,1246000,1246050,0,3,3,0,3,0,9,3,3,3,3,0,0,12,21
348,68552465,2685500,2685550,1246500,1246550,3,3,3,0,3,0,12,0,3,0,0,3,0,6,18
349,68552480,2685500,2685550,1248000,1248050,0,3,0,0,0,0,3,0,0,0,0,0,0,0,3
350,68562474,2685600,2685650,1247400,1247450,3,0,0,0,0,0,3,3,0,0,0,0,0,3,6
351,68562480,2685600,2685650,1248000,1248050,3,0,0,0,0,0,3,0,0,0,0,0,0,0,3
352,68572464,2685700,2685750,1246400,1246450,3,0,0,0,0,0,3,3,3,3,0,0,0,9,12
353,68572515,2685700,2685750,1251500,1251550,3,0,3,0,3,0,9,0,3,3,3,3,3,15,24
354,68582509,2685800,2685850,1250900,1250950,5,0,3,3,3,0,14,5,3,3,3,3,0,17,31
355,68582487,2685800,2685850,1248700,1248750,0,0,0,0,0,0,0,3,0,0,0,0,0,3,3
356,68582505,2685800,2685850,1250500,1250550,0,0,0,0,0,0,0,0,0,0,0,0,0,0,0
357,68582454,2685800,2685850,1245400,1245450,0,0,0,0,0,0,0,0,0,0,0,0,0,0,0
358,68592508,2685900,2685950,1250800,1250850,3,3,3,3,3,0,15,0,7,0,3,3,0,13,28
359,68602515,2686000,2686050,1251500,1251550,3,0,3,0,0,0,6,3,3,3,3,3,0,15,21
360,68612456,2686100,2686150,1245600,1245650,3,3,3,3,3,0,15,3,3,3,0,0,0,9,24
361,68612469,2686100,2686150,1246900,1246950,0,0,0,0,0,0,0,0,0,0,0,0,0,0,0
362,68622457,2686200,2686250,1245700,1245750,3,3,3,0,0,0,9,3,3,0,3,0,0,9,18
363,68622511,2686200,2686250,1251100,1251150,3,0,3,0,3,0,9,4,0,5,6,0,3,18,27
364,68632451,2686300,2686350,1245100,1245150,0,0,0,0,3,0,3,3,3,0,3,3,3,15,18
365,68632455,2686300,2686350,1245500,1245550,0,3,3,0,0,3,9,0,3,3,3,3,0,12,21
366,68632477,2686300,2686350,1247700,1247750,0,0,0,0,0,0,0,0,0,0,3,0,0,3,3
367,68642514,2686400,2686450,1251400,1251450,0,3,3,0,0,0,6,3,0,3,3,0,3,12,18
368,68642477,2686400,2686450,1247700,1247750,0,0,3,0,0,0,3,0,3,0,0,0,0,3,6
369,68652509,2686500,2686550,1250900,1250950,3,3,3,3,0,3,15,3,3,0,3,3,0,12,27
370,68672512,2686700,2686750,1251200,1251250,4,6,0,3,3,0,16,3,5,3,3,3,3,20,36
371,68682460,2686800,2686850,1246000,1246050,3,3,3,3,0,3,15,3,7,3,0,3,4,20,35
372,68682462,2686800,2686850,1246200,1246250,0,3,4,4,4,3,18,3,3,7,9,5,3,30,48
373,68692454,2686900,2686950,1245400,1245450,0,0,0,0,0,0,0,0,0,0,0,0,0,0,0
374,68702460,2687000,2687050,1246000,1246050,5,3,0,3,3,0,14,3,4,5,3,3,3,21,35
375,68702505,2687000,2687050,1250500,1250550,3,3,3,3,0,0,12,3,3,3,0,3,0,12,24
376,68702511,2687000,2687050,1251100,1251150,0,0,0,3,0,0,3,0,3,0,0,0,0,3,6
377,68712503,2687100,2687150,1250300,1250350,3,0,3,0,0,0,6,3,3,3,3,3,0,15,21
378,68752458,2687500,2687550,1245800,1245850,3,3,3,3,4,3,19,4,3,3,5,4,0,19,38
379,68752465,2687500,2687550,1246500,1246550,0,0,0,0,0,0,0,0,0,0,0,0,0,0,0
380,68792457,2687900,2687950,1245700,1245750,0,0,0,3,0,3,6,0,0,3,3,0,0,6,12
381,67762493,2677600,2677650,1249300,1249350,3,0,0,3,0,0,6,3,0,3,0,0,0,6,12
382,67822491,2678200,2678250,1249100,1249150,3,0,3,3,3,0,12,3,4,3,3,3,0,16,28
383,67832490,2678300,2678350,1249000,1249050,3,4,0,4,3,0,14,5,3,4,3,3,0,18,32
384,67832492,2678300,2678350,1249200,1249250,3,3,0,3,0,0,9,3,3,3,3,0,0,12,21
385,67842511,2678400,2678450,1251100,1251150,3,3,3,3,3,3,18,3,3,3,6,3,4,22,40
386,67842513,2678400,2678450,1251300,1251350,0,0,3,0,0,0,3,0,0,0,3,0,0,3,6
387,67852495,2678500,2678550,1249500,1249550,3,4,0,3,0,0,10,9,3,3,0,0,3,18,28
388,67852480,2678500,2678550,1248000,1248050,0,0,0,0,0,0,0,0,0,0,0,0,0,0,0
389,67862522,2678600,2678650,1252200,1252250,3,3,3,3,3,0,15,3,3,0,3,4,0,13,28
390,67862476,2678600,2678650,1247600,1247650,0,0,0,0,0,0,0,0,0,0,0,0,0,0,0
391,67872483,2678700,2678750,1248300,1248350,3,0,3,3,3,0,12,0,0,3,3,3,0,9,21
392,67872517,2678700,2678750,1251700,1251750,3,3,3,0,0,0,9,3,0,3,0,0,0,6,15
393,67882480,2678800,2678850,1248000,1248050,3,5,3,3,0,0,14,5,3,0,0,0,0,8,22
394,67892469,2678900,2678950,1246900,1246950,0,0,0,0,0,0,0,0,0,0,0,0,0,0,0
395,67892507,2678900,2678950,1250700,1250750,3,3,0,3,4,3,16,3,0,0,3,3,0,9,25
396,67892512,2678900,2678950,1251200,1251250,5,4,7,0,3,3,22,6,3,5,0,3,3,20,42
397,67902497,2679000,2679050,1249700,1249750,0,0,0,0,0,0,0,0,0,0,0,0,0,0,0
398,67912511,2679100,2679150,1251100,1251150,3,3,3,0,0,0,9,3,3,3,0,0,0,9,18
399,67922471,2679200,2679250,1247100,1247150,3,3,0,3,0,0,9,3,3,0,3,0,3,12,21
400,67922506,2679200,2679250,1250600,1250650,3,3,0,0,0,0,6,3,3,3,3,0,0,12,18
401,67922479,2679200,2679250,1247900,1247950,4,5,3,4,4,0,20,5,4,8,3,0,3,23,43
402,67932487,2679300,2679350,1248700,1248750,0,3,3,0,0,0,6,0,0,3,0,0,0,3,9
403,67932472,2679300,2679350,1247200,1247250,3,3,0,0,3,0,9,3,3,3,3,3,0,15,24
404,67932474,2679300,2679350,1247400,1247450,3,0,3,3,0,0,9,3,3,4,0,3,0,13,22
405,67942512,2679400,2679450,1251200,1251250,0,3,0,0,0,3,6,3,3,3,3,3,0,15,21
406,67942495,2679400,2679450,1249500,1249550,0,0,0,0,0,0,0,0,0,0,0,0,0,0,0
407,67962533,2679600,2679650,1253300,1253350,0,3,0,0,0,0,3,0,0,0,0,0,0,0,3
408,67972474,2679700,2679750,1247400,1247450,3,3,0,3,0,3,12,3,0,0,3,3,3,12,24
409,67972477,2679700,2679750,1247700,1247750,3,0,3,6,3,3,18,5,3,5,4,3,5,25,43
410,67972500,2679700,2679750,1250000,1250050,0,0,3,0,0,0,3,0,3,3,3,0,0,9,12
411,67982482,2679800,2679850,1248200,1248250,4,0,3,3,0,0,10,3,3,3,0,0,0,9,19
412,67982472,2679800,2679850,1247200,1247250,3,4,3,0,3,3,16,3,4,4,6,6,3,26,42
413,67982504,2679800,2679850,1250400,1250450,0,3,3,0,3,0,9,0,3,3,3,0,0,9,18
414,67992476,2679900,2679950,1247600,1247650,3,7,5,3,3,3,24,7,6,5,4,4,3,29,53
415,68002479,2680000,2680050,1247900,1247950,3,3,3,0,0,0,9,3,3,3,3,0,0,12,21
416,68002529,2680000,2680050,1252900,1252950,3,3,3,0,0,0,9,3,3,0,0,0,0,6,15
417,68002474,2680000,2680050,1247400,1247450,3,0,3,3,3,3,15,3,3,3,0,3,3,15,30
418,68012523,2680100,2680150,1252300,1252350,3,3,0,3,0,0,9,0,3,3,0,0,0,6,15
419,68022524,2680200,2680250,1252400,1252450,3,4,3,3,0,0,13,3,3,3,3,3,0,15,28
420,68022507,2680200,2680250,1250700,1250750,0,3,0,3,0,0,6,3,4,0,0,0,0,7,13
421,68022475,2680200,2680250,1247500,1247550,3,3,0,3,0,0,9,3,3,3,4,3,0,16,25
422,68022479,2680200,2680250,1247900,1247950,3,0,3,0,0,0,6,0,3,3,3,0,0,9,15
423,68032479,2680300,2680350,1247900,1247950,3,3,3,3,0,0,12,6,7,3,0,0,3,19,31
424,68032524,2680300,2680350,1252400,1252450,3,3,3,0,0,0,9,3,3,3,3,3,3,18,27
425,68032510,2680300,2680350,1251000,1251050,3,3,0,0,0,0,6,0,0,0,0,0,0,0,6
426,68042504,2680400,2680450,1250400,1250450,3,3,0,0,0,0,6,3,3,3,0,0,0,9,15
427,68042506,2680400,2680450,1250600,1250650,3,3,4,3,0,0,13,3,3,3,4,0,0,13,26
428,68042480,2680400,2680450,1248000,1248050,3,3,0,3,0,0,9,3,3,3,0,0,4,13,22
429,68042470,2680400,2680450,1247000,1247050,3,0,0,3,0,0,6,3,0,4,3,3,3,16,22
430,68042526,2680400,2680450,1252600,1252650,0,0,3,3,0,0,6,3,0,3,0,3,0,9,15
431,68052466,2680500,2680550,1246600,1246650,3,3,0,3,0,0,9,3,0,0,3,0,0,6,15
432,68052463,2680500,2680550,1246300,1246350,3,0,0,0,0,0,3,3,3,3,3,0,0,12,15
433,68052458,2680500,2680550,1245800,1245850,3,0,0,0,0,0,3,0,0,0,0,0,0,0,3
434,68062527,2680600,2680650,1252700,1252750,0,0,0,0,0,0,0,3,0,0,0,0,0,3,3
435,68062526,2680600,2680650,1252600,1252650,3,3,0,3,3,0,12,3,3,4,7,3,3,23,35
436,68062471,2680600,2680650,1247100,1247150,3,3,3,5,12,11,37,3,3,4,11,26,33,80,117
437,68062499,2680600,2680650,1249900,1249950,3,3,3,0,0,0,9,3,3,3,0,0,3,12,21
438,68072483,2680700,2680750,1248300,1248350,3,3,3,3,3,0,15,0,3,3,3,0,0,9,24
439,68072460,2680700,2680750,1246000,1246050,4,4,3,3,0,3,17,4,3,4,3,0,0,14,31
440,68072534,2680700,2680750,1253400,1253450,3,0,0,0,0,0,3,3,0,0,0,0,0,3,6
441,68082524,2680800,2680850,1252400,1252450,3,3,3,3,3,0,15,3,3,0,3,0,0,9,24
442,68082521,2680800,2680850,1252100,1252150,3,3,3,0,0,0,9,0,3,0,0,3,0,6,15
443,68082534,2680800,2680850,1253400,1253450,3,3,3,0,0,0,9,3,3,3,0,0,0,9,18
444,68092459,2680900,2680950,1245900,1245950,0,3,0,0,0,0,3,0,0,3,3,0,0,6,9
445,68092462,2680900,2680950,1246200,1246250,3,3,0,0,0,0,6,0,0,0,0,0,0,0,6
446,68092503,2680900,2680950,1250300,1250350,4,4,3,3,3,0,17,3,3,3,3,0,3,15,32
447,68092523,2680900,2680950,1252300,1252350,5,3,3,3,3,0,17,3,3,3,4,0,3,16,33
448,68112466,2681100,2681150,1246600,1246650,8,3,3,3,3,0,20,5,3,3,3,3,3,20,40
449,68112529,2681100,2681150,1252900,1252950,3,7,3,3,3,0,19,8,3,3,3,4,0,21,40
450,68112523,2681100,2681150,1252300,1252350,3,0,4,3,3,3,16,3,3,3,7,6,3,25,41
451,68122500,2681200,2681250,1250000,1250050,3,3,3,3,3,0,15,0,3,4,3,3,0,13,28
452,68132472,2681300,2681350,1247200,1247250,4,3,0,3,0,0,10,3,3,3,0,3,3,15,25
453,68132426,2681300,2681350,1242600,1242650,4,0,3,3,3,3,16,4,3,3,3,3,0,16,32
454,68142470,2681400,2681450,1247000,1247050,3,0,3,3,3,0,12,3,5,0,3,3,0,14,26
455,68152425,2681500,2681550,1242500,1242550,3,0,0,0,0,0,3,0,0,0,0,3,0,3,6
456,68152457,2681500,2681550,1245700,1245750,3,4,6,3,3,3,22,5,4,9,3,3,0,24,46
457,68162519,2681600,2681650,1251900,1251950,0,0,0,0,0,0,0,0,0,0,0,0,0,0,0
458,68162520,2681600,2681650,1252000,1252050,0,3,3,3,0,0,9,3,3,3,3,0,0,12,21
459,68162466,2681600,2681650,1246600,1246650,3,3,3,0,0,0,9,3,3,0,0,0,0,6,15
460,68172532,2681700,2681750,1253200,1253250,3,0,3,3,3,0,12,5,3,3,0,0,0,11,23
461,68172436,2681700,2681750,1243600,1243650,3,3,3,3,0,0,12,3,5,0,0,0,0,8,20
462,68172435,2681700,2681750,1243500,1243550,3,3,0,0,0,0,6,3,0,3,0,0,0,6,12
463,68172445,2681700,2681750,1244500,1244550,3,0,0,0,0,0,3,0,0,0,0,0,0,0,3
464,68182498,2681800,2681850,1249800,1249850,0,3,0,3,0,0,6,3,3,0,3,0,3,12,18
465,68182437,2681800,2681850,1243700,1243750,0,0,0,0,0,0,0,0,0,0,0,0,0,0,0
466,68182518,2681800,2681850,1251800,1251850,3,0,0,0,0,0,3,3,0,3,0,3,0,9,12
467,68182500,2681800,2681850,1250000,1250050,3,3,3,0,0,0,9,6,3,3,0,0,3,15,24
468,68182441,2681800,2681850,1244100,1244150,0,3,0,0,0,0,3,0,3,0,0,0,0,3,6
469,68182514,2681800,2681850,1251400,1251450,0,0,0,0,0,0,0,0,0,0,3,0,0,3,3
470,68192471,2681900,2681950,1247100,1247150,3,0,3,3,0,0,9,0,3,3,3,3,0,12,21
471,68192499,2681900,2681950,1249900,1249950,3,0,0,3,3,3,12,3,3,3,0,3,3,15,27
472,68192530,2681900,2681950,1253000,1253050,0,0,0,0,0,0,0,0,0,0,0,0,0,0,0
473,68202488,2682000,2682050,1248800,1248850,3,3,0,3,0,3,12,8,3,0,0,0,3,14,26
474,68202501,2682000,2682050,1250100,1250150,0,0,0,0,3,0,3,3,0,0,0,3,0,6,9
475,68202496,2682000,2682050,1249600,1249650,3,3,3,3,0,0,12,3,0,3,0,0,3,9,21
476,68202451,2682000,2682050,1245100,1245150,0,0,0,0,0,0,0,0,0,0,0,0,0,0,0
477,68212488,2682100,2682150,1248800,1248850,3,3,3,0,3,0,12,4,4,3,0,3,3,17,29
478,68212494,2682100,2682150,1249400,1249450,0,0,0,0,3,0,3,0,0,0,3,0,0,3,6
479,68222459,2682200,2682250,1245900,1245950,3,4,3,3,3,3,19,3,7,3,4,3,3,23,42
480,68222472,2682200,2682250,1247200,1247250,6,3,3,0,0,0,12,3,3,0,0,0,0,6,18
481,68222439,2682200,2682250,1243900,1243950,3,3,0,0,0,3,9,3,3,3,3,0,0,12,21
482,68222458,2682200,2682250,1245800,1245850,5,8,3,3,3,3,25,9,10,3,4,3,3,32,57
483,68222486,2682200,2682250,1248600,1248650,3,0,0,3,0,0,6,3,0,3,0,0,0,6,12
484,68232502,2682300,2682350,1250200,1250250,3,3,3,3,0,3,15,3,0,3,0,0,3,9,24
485,68232522,2682300,2682350,1252200,1252250,0,0,3,0,0,0,3,3,0,3,3,0,0,9,12
486,68232435,2682300,2682350,1243500,1243550,3,0,0,0,0,0,3,0,0,3,0,0,0,3,6
487,68242476,2682400,2682450,1247600,1247650,0,3,3,0,0,0,6,3,4,0,0,0,0,7,13
488,68242440,2682400,2682450,1244000,1244050,3,3,3,3,3,3,18,3,3,3,3,3,3,18,36
489,68242462,2682400,2682450,1246200,1246250,0,0,3,0,3,0,6,3,0,3,4,0,0,10,16
490,68242442,2682400,2682450,1244200,1244250,0,5,4,3,0,3,15,5,4,4,4,3,3,23,38
491,68242473,2682400,2682450,1247300,1247350,0,0,0,0,0,0,0,0,0,0,0,0,0,0,0
492,68242435,2682400,2682450,1243500,1243550,0,0,0,0,0,0,0,0,3,3,3,3,3,15,15
493,68252498,2682500,2682550,1249800,1249850,5,3,0,3,0,0,11,5,0,3,0,0,3,11,22
494,68252499,2682500,2682550,1249900,1249950,3,0,3,0,0,0,6,3,4,3,3,0,0,13,19
495,68252515,2682500,2682550,1251500,1251550,4,3,3,3,0,0,13,3,3,3,3,0,0,12,25
496,68252437,2682500,2682550,1243700,1243750,3,0,3,0,3,0,9,3,3,0,3,3,0,12,21
497,68252444,2682500,2682550,1244400,1244450,3,3,3,3,0,0,12,3,3,3,3,0,3,15,27
498,68252502,2682500,2682550,1250200,1250250,0,3,3,0,0,0,6,3,3,3,0,3,0,12,18
499,68252430,2682500,2682550,1243000,1243050,3,0,0,0,0,0,3,0,0,0,0,0,0,0,3
500,68252465,2682500,2682550,1246500,1246550,0,0,0,0,0,0,0,0,0,0,0,0,0,0,0
501,68262431,2682600,2682650,1243100,1243150,0,0,0,0,3,3,6,3,3,3,3,5,3,20,26
502,68262483,2682600,2682650,1248300,1248350,3,0,0,0,0,0,3,3,0,0,0,0,0,3,6
503,68262459,2682600,2682650,1245900,1245950,3,3,3,3,0,0,12,3,3,3,0,0,0,9,21
504,68272491,2682700,2682750,1249100,1249150,0,0,0,3,0,0,3,0,0,3,3,3,0,9,12
505,68272469,2682700,2682750,1246900,1246950,0,3,0,3,0,0,6,3,3,3,3,3,0,15,21
506,68272486,2682700,2682750,1248600,1248650,0,0,0,0,0,0,0,0,0,0,0,0,0,0,0
507,68272506,2682700,2682750,1250600,1250650,0,0,0,0,0,0,0,0,0,0,0,0,0,0,0
508,68272507,2682700,2682750,1250700,1250750,0,0,0,0,0,0,0,0,0,0,0,0,0,0,0
509,68282526,2682800,2682850,1252600,1252650,5,3,3,0,3,0,14,5,3,0,3,3,0,14,28
510,68282504,2682800,2682850,1250400,1250450,3,0,0,0,3,0,6,3,0,0,3,0,3,9,15
511,68282442,2682800,2682850,1244200,1244250,0,0,0,0,0,0,0,0,0,0,0,0,3,3,3
512,68282508,2682800,2682850,1250800,1250850,0,0,0,0,0,0,0,3,3,3,0,0,0,9,9
513,68292493,2682900,2682950,1249300,1249350,3,0,3,3,0,3,12,3,5,3,3,3,0,17,29
514,68292515,2682900,2682950,1251500,1251550,3,3,3,3,0,0,12,0,3,3,3,3,3,15,27
515,68292433,2682900,2682950,1243300,1243350,0,3,3,0,0,0,6,0,3,0,0,0,3,6,12
516,67802484,2678000,2678050,1248400,1248450,3,0,0,0,0,0,3,0,0,0,0,0,0,0,3
517,68202494,2682000,2682050,1249400,1249450,0,0,0,0,0,0,0,0,0,0,0,0,0,0,0
518,67862520,2678600,2678650,1252000,1252050,3,3,0,0,0,0,6,3,3,0,0,0,0,6,12
519,68152517,2681500,2681550,1251700,1251750,0,0,3,0,0,0,3,0,0,0,0,0,0,0,3
520,68572508,2685700,2685750,1250800,1250850,0,0,0,0,0,0,0,0,0,0,3,0,0,3,3
521,67782496,2677800,2677850,1249600,1249650,3,6,3,3,0,0,15,5,3,3,0,0,0,11,26
522,67802490,2678000,2678050,1249000,1249050,3,3,3,3,0,0,12,0,0,3,0,0,0,3,15
523,67802493,2678000,2678050,1249300,1249350,4,4,3,3,0,0,14,6,3,3,3,0,0,15,29
524,67822489,2678200,2678250,1248900,1248950,4,5,3,3,3,3,21,3,3,7,6,3,0,22,43
525,67832488,2678300,2678350,1248800,1248850,3,0,0,3,0,0,6,3,3,0,0,0,0,6,12
526,67852511,2678500,2678550,1251100,1251150,6,5,6,3,4,3,27,12,6,4,3,7,3,35,62
527,67862478,2678600,2678650,1247800,1247850,3,3,3,0,0,3,12,3,3,3,3,0,3,15,27
528,67862517,2678600,2678650,1251700,1251750,3,3,3,0,0,0,9,3,3,0,3,0,0,9,18
529,67862479,2678600,2678650,1247900,1247950,4,3,0,3,0,0,10,3,0,3,0,0,0,6,16
530,67872508,2678700,2678750,1250800,1250850,0,0,3,3,3,0,9,3,3,3,3,3,0,15,24
531,67882507,2678800,2678850,1250700,1250750,3,3,0,0,0,0,6,3,0,0,0,0,0,3,9
532,67892492,2678900,2678950,1249200,1249250,3,0,4,3,3,0,13,3,3,3,3,0,0,12,25
533,67892516,2678900,2678950,1251600,1251650,3,4,3,3,3,0,16,4,0,3,6,3,3,19,35
534,67892495,2678900,2678950,1249500,1249550,3,0,0,0,0,0,3,0,3,0,0,0,0,3,6
535,67892477,2678900,2678950,1247700,1247750,0,0,0,0,0,0,0,3,3,0,0,0,0,6,6
536,67892517,2678900,2678950,1251700,1251750,0,0,3,3,0,0,6,3,0,0,5,3,3,14,20
537,67892515,2678900,2678950,1251500,1251550,3,0,3,0,3,0,9,0,3,3,0,3,3,12,21
538,67902495,2679000,2679050,1249500,1249550,0,0,0,0,0,0,0,0,0,0,0,0,0,0,0
539,67902471,2679000,2679050,1247100,1247150,3,3,0,0,0,0,6,0,0,0,0,0,0,0,6
540,67912508,2679100,2679150,1250800,1250850,4,3,3,0,3,3,16,3,3,0,3,3,0,12,28
541,67912487,2679100,2679150,1248700,1248750,3,3,3,3,0,0,12,4,3,0,0,0,3,10,22
542,67912515,2679100,2679150,1251500,1251550,3,0,3,0,0,0,6,3,0,3,0,0,0,6,12
543,67912480,2679100,2679150,1248000,1248050,0,4,3,5,5,4,21,3,5,5,14,22,21,70,91
544,67922473,2679200,2679250,1247300,1247350,3,0,3,3,0,0,9,4,0,6,5,3,3,21,30
545,67922514,2679200,2679250,1251400,1251450,0,0,0,0,0,0,0,0,0,3,0,0,0,3,3
546,67922490,2679200,2679250,1249000,1249050,0,3,3,5,3,0,14,5,4,5,4,4,3,25,39
547,67922494,2679200,2679250,1249400,1249450,4,3,4,3,3,0,17,6,5,6,6,3,3,29,46
548,67942510,2679400,2679450,1251000,1251050,0,0,0,0,0,0,0,3,3,0,3,3,0,12,12
549,67942509,2679400,2679450,1250900,1250950,3,3,4,0,0,0,10,3,3,0,0,0,0,6,16
550,67952512,2679500,2679550,1251200,1251250,0,3,3,3,3,3,15,0,3,4,3,3,3,16,31
551,67962487,2679600,2679650,1248700,1248750,3,3,3,0,0,0,9,3,0,3,0,0,0,6,15
552,67962529,2679600,2679650,1252900,1252950,3,0,3,3,0,0,9,3,3,3,3,0,3,15,24
553,67962493,2679600,2679650,1249300,1249350,0,0,0,0,0,0,0,0,3,0,0,0,0,3,3
554,67972470,2679700,2679750,1247000,1247050,3,5,7,4,3,0,22,8,3,4,4,4,3,26,48
555,67972508,2679700,2679750,1250800,1250850,4,3,3,3,3,0,16,4,3,3,0,3,3,16,32
556,67972482,2679700,2679750,1248200,1248250,5,3,3,0,0,0,11,3,3,3,3,0,0,12,23
557,67972468,2679700,2679750,1246800,1246850,6,3,3,0,3,0,15,7,3,4,6,3,3,26,41
558,67972490,2679700,2679750,1249000,1249050,0,0,0,0,0,0,0,0,0,0,0,0,0,0,0
559,67982478,2679800,2679850,1247800,1247850,3,4,3,3,3,0,16,4,6,3,3,3,0,19,35
560,67982511,2679800,2679850,1251100,1251150,4,3,4,3,3,0,17,3,0,5,3,3,3,17,34
561,67982528,2679800,2679850,1252800,1252850,4,3,4,3,0,0,14,3,3,4,3,0,3,16,30
562,67992474,2679900,2679950,1247400,1247450,9,14,9,6,3,0,41,13,13,5,4,4,3,42,83
563,68002527,2680000,2680050,1252700,1252750,7,7,3,3,0,0,20,8,8,3,3,0,0,22,42
564,68012502,2680100,2680150,1250200,1250250,3,3,3,3,0,0,12,3,0,0,3,0,0,6,18
565,68012464,2680100,2680150,1246400,1246450,0,0,0,0,0,0,0,0,0,0,0,0,0,0,0
566,68012485,2680100,2680150,1248500,1248550,0,0,3,3,0,0,6,3,0,3,3,3,0,12,18
567,68012473,2680100,2680150,1247300,1247350,3,3,3,5,10,7,31,3,3,3,5,24,31,69,100
568,68022470,2680200,2680250,1247000,1247050,3,3,0,0,0,0,6,3,0,0,0,0,3,6,12
569,68022504,2680200,2680250,1250400,1250450,3,3,0,3,0,0,9,3,3,3,3,3,3,18,27
570,68032468,2680300,2680350,1246800,1246850,0,0,0,0,3,0,3,3,3,0,0,3,0,9,12
571,68032476,2680300,2680350,1247600,1247650,0,3,3,3,0,0,9,3,3,0,3,3,0,12,21
572,68042501,2680400,2680450,1250100,1250150,8,3,4,3,3,0,21,6,5,3,3,0,0,17,38
573,68042510,2680400,2680450,1251000,1251050,0,0,0,0,0,0,0,0,0,0,0,0,0,0,0
574,68042502,2680400,2680450,1250200,1250250,3,3,3,3,3,0,15,6,3,3,3,0,0,15,30
575,68042482,2680400,2680450,1248200,1248250,6,3,3,0,0,0,12,3,3,0,3,3,0,12,24
576,68052506,2680500,2680550,1250600,1250650,0,3,3,3,3,0,12,4,3,3,4,3,0,17,29
577,68052465,2680500,2680550,1246500,1246550,3,0,0,0,0,0,3,0,0,0,0,0,0,0,3
578,68052525,2680500,2680550,1252500,1252550,3,3,3,3,0,0,12,3,3,3,6,3,0,18,30
579,68052484,2680500,2680550,1248400,1248450,3,0,0,0,0,0,3,0,0,0,0,0,0,0,3
580,68052487,2680500,2680550,1248700,1248750,0,0,0,0,0,0,0,0,0,0,0,0,0,0,0
581,68052528,2680500,2680550,1252800,1252850,3,0,3,0,0,0,6,3,3,3,0,0,0,9,15
582,68062470,2680600,2680650,1247000,1247050,4,3,3,3,0,0,13,3,3,0,0,0,0,6,19
583,68062495,2680600,2680650,1249500,1249550,3,3,0,0,0,0,6,0,0,0,0,0,0,0,6
584,68072468,2680700,2680750,1246800,1246850,3,3,3,0,0,0,9,3,3,0,3,3,3,15,24
585,68072521,2680700,2680750,1252100,1252150,3,3,3,3,0,0,12,3,3,3,3,0,0,12,24
586,68072472,2680700,2680750,1247200,1247250,3,3,3,3,3,0,15,3,3,3,3,3,3,18,33
587,68072519,2680700,2680750,1251900,1251950,3,3,3,3,3,0,15,3,4,6,3,3,3,22,37
588,68072456,2680700,2680750,1245600,1245650,3,3,0,3,0,0,9,0,0,3,0,0,0,3,12
589,68072518,2680700,2680750,1251800,1251850,3,4,4,4,4,3,22,5,5,11,3,3,3,30,52
590,68072535,2680700,2680750,1253500,1253550,0,0,3,0,0,0,3,0,3,0,0,0,0,3,6
591,68072526,2680700,2680750,1252600,1252650,5,3,3,3,0,0,14,4,3,3,3,3,0,16,30
592,68082500,2680800,2680850,1250000,1250050,0,0,3,3,0,0,6,0,3,5,3,0,3,14,20
593,68082533,2680800,2680850,1253300,1253350,3,0,0,3,0,0,6,0,0,0,3,0,0,3,9
594,68082482,2680800,2680850,1248200,1248250,9,5,3,5,3,0,25,3,10,4,5,5,3,30,55
595,68092517,2680900,2680950,1251700,1251750,3,3,0,0,0,0,6,3,3,0,0,0,0,6,12
596,68102503,2681000,2681050,1250300,1250350,3,3,0,3,0,0,9,3,3,0,0,3,0,9,18
597,68102523,2681000,2681050,1252300,1252350,3,3,3,3,3,0,15,3,3,0,3,0,0,9,24
598,68102463,2681000,2681050,1246300,1246350,0,0,0,0,0,0,0,0,0,0,0,0,0,0,0
599,68112473,2681100,2681150,1247300,1247350,9,3,5,0,5,0,22,8,5,3,5,3,0,24,46
600,68112482,2681100,2681150,1248200,1248250,0,0,0,3,0,3,6,0,3,3,0,0,0,6,12
601,68122498,2681200,2681250,1249800,1249850,3,3,0,0,0,0,6,3,0,0,0,0,0,3,9
602,68132481,2681300,2681350,1248100,1248150,3,4,4,3,0,0,14,7,6,3,3,3,3,25,39
603,68132433,2681300,2681350,1243300,1243350,3,3,3,3,3,0,15,0,0,3,3,0,0,6,21
604,68132484,2681300,2681350,1248400,1248450,0,0,0,3,0,0,3,0,0,3,3,0,0,6,9
605,68132470,2681300,2681350,1247000,1247050,3,3,0,3,0,0,9,3,0,3,0,3,0,9,18
606,68142492,2681400,2681450,1249200,1249250,3,0,0,0,0,0,3,3,3,0,0,0,0,6,9
607,68142475,2681400,2681450,1247500,1247550,3,3,3,0,4,0,13,6,4,4,3,3,3,23,36
608,68152422,2681500,2681550,1242200,1242250,5,3,3,3,3,0,17,4,7,5,4,3,0,23,40
609,68152502,2681500,2681550,1250200,1250250,3,3,0,0,0,0,6,3,3,0,0,0,0,6,12
610,68152519,2681500,2681550,1251900,1251950,0,3,0,0,3,0,6,0,3,3,0,3,0,9,15
611,68152531,2681500,2681550,1253100,1253150,5,3,3,3,3,0,17,4,3,3,0,0,3,13,30
612,68152421,2681500,2681550,1242100,1242150,3,0,0,0,0,0,3,3,0,0,3,0,0,6,9
613,68152463,2681500,2681550,1246300,1246350,3,3,3,0,0,0,9,0,0,0,0,0,0,0,9
614,68162457,2681600,2681650,1245700,1245750,3,3,3,3,0,0,12,3,3,3,0,0,0,9,21
615,68162432,2681600,2681650,1243200,1243250,3,3,3,3,0,0,12,0,3,3,3,3,0,12,24
616,68162468,2681600,2681650,1246800,1246850,4,3,3,3,3,0,16,4,4,3,5,0,3,19,35
617,68172474,2681700,2681750,1247400,1247450,4,4,5,3,0,0,16,5,4,3,3,0,0,15,31
618,68172462,2681700,2681750,1246200,1246250,3,3,0,0,0,0,6,3,3,3,0,3,0,12,18
619,68182480,2681800,2681850,1248000,1248050,0,0,0,0,0,0,0,0,0,0,0,0,0,0,0
620,68192474,2681900,2681950,1247400,1247450,3,4,3,3,0,0,13,3,5,5,3,3,3,22,35
621,68192519,2681900,2681950,1251900,1251950,4,3,3,3,3,0,16,3,3,3,4,3,0,16,32
622,68192472,2681900,2681950,1247200,1247250,3,3,0,0,0,0,6,3,3,0,0,0,0,6,12
623,68192479,2681900,2681950,1247900,1247950,7,3,3,3,0,3,19,3,3,3,3,0,0,12,31
624,68192473,2681900,2681950,1247300,1247350,3,0,0,3,0,0,6,0,0,0,0,0,0,0,6
625,68192463,2681900,2681950,1246300,1246350,0,3,3,0,0,0,6,3,0,0,0,0,3,6,12
626,68192480,2681900,2681950,1248000,1248050,3,0,0,0,0,0,3,3,0,0,0,0,0,3,6
627,68192488,2681900,2681950,1248800,1248850,3,0,0,0,0,0,3,0,0,0,0,0,0,0,3
628,68202479,2682000,2682050,1247900,1247950,0,0,0,0,0,0,0,0,3,3,3,0,0,9,9
629,68212442,2682100,2682150,1244200,1244250,3,3,3,0,0,0,9,3,0,3,0,0,0,6,15
630,68212520,2682100,2682150,1252000,1252050,3,3,0,3,0,0,9,3,3,0,0,3,3,12,21
631,68212446,2682100,2682150,1244600,1244650,3,0,3,3,0,0,9,3,0,3,0,0,0,6,15
632,68222462,2682200,2682250,1246200,1246250,0,0,0,3,0,0,3,3,0,0,3,0,0,6,9
633,68222521,2682200,2682250,1252100,1252150,3,3,3,0,3,0,12,3,3,3,0,3,3,15,27
634,68222455,2682200,2682250,1245500,1245550,3,3,0,3,3,0,12,3,3,3,3,3,0,15,27
635,68222477,2682200,2682250,1247700,1247750,3,4,3,0,0,3,13,3,3,3,0,3,0,12,25
636,68232482,2682300,2682350,1248200,1248250,3,0,3,3,0,0,9,0,3,0,0,0,0,3,12
637,68242514,2682400,2682450,1251400,1251450,3,3,0,0,3,0,9,3,0,0,3,3,0,9,18
638,68242515,2682400,2682450,1251500,1251550,3,3,4,0,3,0,13,0,3,3,3,3,0,12,25
639,68242486,2682400,2682450,1248600,1248650,0,3,3,0,3,0,9,0,0,3,0,0,0,3,12
640,68242518,2682400,2682450,1251800,1251850,10,3,3,3,0,0,19,7,3,6,4,3,3,26,45
641,68242450,2682400,2682450,1245000,1245050,3,3,3,3,3,0,15,3,3,3,3,0,0,12,27
642,68242501,2682400,2682450,1250100,1250150,3,4,0,0,0,3,10,3,3,3,0,0,0,9,19
643,68242455,2682400,2682450,1245500,1245550,3,3,0,0,0,0,6,0,0,0,0,3,0,3,9
644,68242492,2682400,2682450,1249200,1249250,0,3,0,0,0,0,3,3,3,0,0,0,0,6,9
645,68242468,2682400,2682450,1246800,1246850,0,0,0,0,0,0,0,0,0,0,0,0,0,0,0
646,68252447,2682500,2682550,1244700,1244750,3,3,3,0,0,0,9,3,3,0,0,0,0,6,15
647,68252495,2682500,2682550,1249500,1249550,3,3,3,0,0,0,9,3,4,3,3,0,0,13,22
648,68252487,2682500,2682550,1248700,1248750,0,0,3,0,0,0,3,3,0,0,0,0,0,3,6
649,68252467,2682500,2682550,1246700,1246750,3,0,0,0,0,0,3,3,0,0,3,0,0,6,9
650,68262510,2682600,2682650,1251000,1251050,3,3,3,3,3,0,15,6,4,9,6,3,8,36,51
651,68262434,2682600,2682650,1243400,1243450,3,4,3,4,0,0,14,8,0,3,0,3,3,17,31
652,68262509,2682600,2682650,1250900,1250950,0,0,3,0,3,0,6,3,0,3,0,3,0,9,15
653,68262497,2682600,2682650,1249700,1249750,3,3,3,0,3,0,12,3,3,5,0,3,3,17,29
654,68262442,2682600,2682650,1244200,1244250,3,0,3,0,0,0,6,3,4,3,0,3,0,13,19
655,68272445,2682700,2682750,1244500,1244550,0,0,3,3,3,3,12,0,3,3,4,3,3,16,28
656,68282430,2682800,2682850,1243000,1243050,3,3,3,0,3,3,15,6,3,3,0,3,3,18,33
657,68282510,2682800,2682850,1251000,1251050,0,0,3,0,0,0,3,0,3,0,0,0,0,3,6
658,68282446,2682800,2682850,1244600,1244650,0,0,0,0,0,0,0,0,0,0,0,0,0,0,0
659,68282434,2682800,2682850,1243400,1243450,0,3,0,0,3,0,6,0,3,0,0,0,0,3,9
660,68292439,2682900,2682950,1243900,1243950,0,3,0,3,3,0,9,0,3,3,3,0,0,9,18
661,68292525,2682900,2682950,1252500,1252550,3,3,3,3,3,3,18,3,3,3,3,0,3,15,33
662,68292440,2682900,2682950,1244000,1244050,0,0,0,0,0,0,0,0,0,0,0,0,0,0,0
663,68302474,2683000,2683050,1247400,1247450,3,0,0,0,0,0,3,0,0,0,3,0,0,3,6
664,68312470,2683100,2683150,1247000,1247050,3,0,0,0,0,0,3,0,0,0,0,0,0,0,3
665,68312515,2683100,2683150,1251500,1251550,3,3,0,0,0,0,6,0,0,0,3,0,0,3,9
666,68312469,2683100,2683150,1246900,1246950,0,0,0,0,0,0,0,0,0,0,0,0,0,0,0
667,68312472,2683100,2683150,1247200,1247250,0,0,0,3,0,3,6,0,3,3,3,0,0,9,15
668,68322508,2683200,2683250,1250800,1250850,3,3,0,3,0,0,9,0,3,3,3,0,0,9,18
669,68322537,2683200,2683250,1253700,1253750,0,5,3,3,0,3,14,7,3,3,3,0,3,19,33
670,68322490,2683200,2683250,1249000,1249050,0,0,0,0,0,0,0,0,0,0,0,0,0,0,0
671,68332473,2683300,2683350,1247300,1247350,0,0,3,3,0,0,6,0,3,3,0,0,0,6,12
672,68332515,2683300,2683350,1251500,1251550,3,3,3,3,3,0,15,3,3,3,3,3,0,15,30
673,68342535,2683400,2683450,1253500,1253550,3,3,3,0,0,3,12,4,6,3,3,4,0,20,32
674,68342520,2683400,2683450,1252000,1252050,3,3,3,3,0,3,15,4,0,3,0,3,3,13,28
675,68342519,2683400,2683450,1251900,1251950,3,0,3,0,0,0,6,3,0,0,3,3,3,12,18
676,68352506,2683500,2683550,1250600,1250650,3,3,0,0,3,0,9,4,3,3,0,0,0,10,19
677,68352521,2683500,2683550,1252100,1252150,0,5,3,3,3,0,14,3,3,4,3,3,3,19,33
678,68352513,2683500,2683550,1251300,1251350,3,0,3,3,0,0,9,3,3,0,3,3,0,12,21
679,68352483,2683500,2683550,1248300,1248350,3,0,0,3,0,0,6,3,3,3,0,3,3,15,21
680,68352515,2683500,2683550,1251500,1251550,3,3,0,3,3,0,12,3,3,3,3,3,0,15,27
681,68352496,2683500,2683550,1249600,1249650,3,3,3,0,0,3,12,3,5,3,3,3,0,17,29
682,68352523,2683500,2683550,1252300,1252350,0,3,3,0,0,0,6,3,0,3,0,0,3,9,15
683,68362535,2683600,2683650,1253500,1253550,8,3,3,3,0,0,17,3,3,3,0,3,3,15,32
684,68362498,2683600,2683650,1249800,1249850,3,0,0,3,0,0,6,3,0,0,3,0,0,6,12
685,68362478,2683600,2683650,1247800,1247850,0,3,0,0,3,3,9,0,0,0,0,0,0,0,9
686,68362507,2683600,2683650,1250700,1250750,0,3,3,0,0,0,6,0,4,0,0,3,0,7,13
687,68362512,2683600,2683650,1251200,1251250,0,0,3,0,0,0,3,0,0,3,0,0,0,3,6
688,68372510,2683700,2683750,1251000,1251050,3,3,4,5,0,0,15,4,3,3,3,0,3,16,31
689,68382461,2683800,2683850,1246100,1246150,3,4,3,3,0,0,13,5,3,4,3,0,0,15,28
690,68382527,2683800,2683850,1252700,1252750,3,3,3,0,3,0,12,3,0,3,3,3,3,15,27
691,68382494,2683800,2683850,1249400,1249450,0,3,3,3,0,3,12,3,3,3,0,3,0,12,24
692,68382497,2683800,2683850,1249700,1249750,3,0,0,0,0,0,3,0,0,0,0,0,0,0,3
693,68382471,2683800,2683850,1247100,1247150,0,0,0,0,3,3,6,0,0,3,3,0,0,6,12
694,68392494,2683900,2683950,1249400,1249450,3,3,0,3,3,0,12,3,3,3,3,3,0,15,27
695,68392490,2683900,2683950,1249000,1249050,0,4,4,0,3,0,11,3,7,8,10,5,3,36,47
696,68392487,2683900,2683950,1248700,1248750,5,3,0,3,3,3,17,3,3,3,4,3,3,19,36
697,68392462,2683900,2683950,1246200,1246250,3,0,0,0,0,0,3,6,3,0,3,3,0,15,18
698,68392496,2683900,2683950,1249600,1249650,3,3,3,3,3,0,15,3,3,3,3,0,3,15,30
699,68402485,2684000,2684050,1248500,1248550,5,3,3,3,3,0,17,5,3,3,3,3,3,20,37
700,68402512,2684000,2684050,1251200,1251250,3,3,0,0,0,0,6,3,3,0,3,3,0,12,18
701,68402462,2684000,2684050,1246200,1246250,0,3,3,0,3,0,9,6,3,5,3,0,0,17,26
702,68402495,2684000,2684050,1249500,1249550,3,0,0,0,0,0,3,0,0,0,0,3,0,3,6
703,68402527,2684000,2684050,1252700,1252750,0,0,3,0,0,0,3,0,0,3,0,0,0,3,6
704,68402494,2684000,2684050,1249400,1249450,3,3,3,0,3,0,12,3,3,3,0,3,3,15,27
705,68402492,2684000,2684050,1249200,1249250,0,0,3,3,3,0,9,3,3,3,0,0,0,9,18
706,68402535,2684000,2684050,1253500,1253550,3,3,5,3,3,0,17,3,4,6,3,0,0,16,33
707,68402475,2684000,2684050,1247500,1247550,3,0,0,3,0,0,6,0,0,0,3,3,3,9,15
708,68402474,2684000,2684050,1247400,1247450,0,0,0,0,0,0,0,0,0,0,0,0,0,0,0
709,68402473,2684000,2684050,1247300,1247350,0,0,0,0,0,0,0,0,0,0,0,0,0,0,0
710,68412529,2684100,2684150,1252900,1252950,3,0,3,0,0,0,6,0,3,3,3,0,0,9,15
711,68412468,2684100,2684150,1246800,1246850,3,0,0,3,0,3,9,4,0,5,3,0,0,12,21
712,68412516,2684100,2684150,1251600,1251650,3,3,0,0,0,0,6,3,3,3,3,0,3,15,21
713,68412491,2684100,2684150,1249100,1249150,0,0,0,0,0,0,0,0,0,0,0,0,0,0,0
714,68422513,2684200,2684250,1251300,1251350,0,0,3,3,0,0,6,0,3,3,3,0,0,9,15
715,68422527,2684200,2684250,1252700,1252750,3,3,0,0,0,0,6,0,3,0,0,0,0,3,9
716,68422459,2684200,2684250,1245900,1245950,0,3,3,0,0,0,6,0,3,0,0,0,0,3,9
717,68422509,2684200,2684250,1250900,1250950,3,0,3,0,0,0,6,3,0,0,0,0,3,6,12
718,68422467,2684200,2684250,1246700,1246750,3,0,0,0,0,0,3,0,3,0,3,0,3,9,12
719,68432482,2684300,2684350,1248200,1248250,3,3,0,3,3,0,12,0,3,3,3,4,8,21,33
720,68432453,2684300,2684350,1245300,1245350,3,0,0,3,3,0,9,0,3,3,3,0,3,12,21
721,68432466,2684300,2684350,1246600,1246650,3,3,3,0,3,3,15,3,4,3,0,3,0,13,28
722,68432523,2684300,2684350,1252300,1252350,0,0,0,0,0,0,0,0,0,0,0,0,0,0,0
723,68432458,2684300,2684350,1245800,1245850,3,3,3,0,3,3,15,3,7,3,3,4,0,20,35
724,68432522,2684300,2684350,1252200,1252250,0,0,0,0,0,0,0,0,0,0,0,0,0,0,0
725,68442455,2684400,2684450,1245500,1245550,8,7,3,3,3,3,27,7,13,4,3,3,3,33,60
726,68442463,2684400,2684450,1246300,1246350,0,0,0,0,0,0,0,3,0,3,3,3,0,12,12
727,68452467,2684500,2684550,1246700,1246750,3,3,3,0,0,3,12,4,3,3,0,3,0,13,25
728,68452485,2684500,2684550,1248500,1248550,4,3,4,0,0,3,14,5,3,3,3,0,0,14,28
729,68452487,2684500,2684550,1248700,1248750,3,0,3,3,0,0,9,0,3,3,0,0,3,9,18
730,68452462,2684500,2684550,1246200,1246250,3,0,0,3,0,0,6,0,0,3,3,0,3,9,15
731,68472480,2684700,2684750,1248000,1248050,0,3,0,0,0,0,3,3,0,0,3,0,0,6,9
732,68472479,2684700,2684750,1247900,1247950,3,3,0,0,3,0,9,3,3,3,3,3,3,18,27
733,68472519,2684700,2684750,1251900,1251950,3,4,3,3,3,0,16,3,0,3,3,3,3,15,31
734,68482480,2684800,2684850,1248000,1248050,0,0,3,0,0,3,6,3,3,3,3,3,0,15,21
735,68482518,2684800,2684850,1251800,1251850,4,4,3,3,3,0,17,8,5,3,4,3,3,26,43
736,68482454,2684800,2684850,1245400,1245450,0,0,0,3,0,0,3,0,0,0,0,0,0,0,3
737,68482517,2684800,2684850,1251700,1251750,3,3,3,0,0,0,9,0,3,3,0,3,3,12,21
738,68482458,2684800,2684850,1245800,1245850,0,0,0,0,0,0,0,0,0,0,0,0,0,0,0
739,68482447,2684800,2684850,1244700,1244750,0,0,0,0,0,0,0,0,0,0,0,0,0,0,0
740,68492449,2684900,2684950,1244900,1244950,4,5,3,0,3,0,15,6,3,3,3,0,3,18,33
741,68492470,2684900,2684950,1247000,1247050,4,3,3,0,3,0,13,10,3,0,3,3,0,19,32
742,68492514,2684900,2684950,1251400,1251450,3,0,3,0,0,0,6,3,3,3,0,0,0,9,15
743,68502475,2685000,2685050,1247500,1247550,3,3,0,0,3,0,9,3,3,3,0,0,3,12,21
744,68512516,2685100,2685150,1251600,1251650,3,3,0,0,3,3,12,0,3,3,3,0,3,12,24
745,68512468,2685100,2685150,1246800,1246850,3,0,3,0,0,3,9,3,3,3,0,3,3,15,24
746,68512514,2685100,2685150,1251400,1251450,3,0,3,0,3,3,12,3,3,3,0,0,3,12,24
747,68512470,2685100,2685150,1247000,1247050,0,3,3,0,0,0,6,0,3,3,3,0,0,9,15
748,68522450,2685200,2685250,1245000,1245050,3,3,3,3,0,0,12,3,3,3,3,0,0,12,24
749,68522475,2685200,2685250,1247500,1247550,3,3,3,3,0,0,12,0,3,3,3,0,3,12,24
750,68522472,2685200,2685250,1247200,1247250,0,0,3,0,0,0,3,0,3,3,0,0,0,6,9
751,68522477,2685200,2685250,1247700,1247750,0,0,0,0,0,0,0,0,0,3,0,0,0,3,3
752,68522483,2685200,2685250,1248300,1248350,0,3,3,3,3,3,15,3,3,3,3,0,0,12,27
753,68532470,2685300,2685350,1247000,1247050,0,3,0,0,0,0,3,0,3,3,0,0,0,6,9
754,68542448,2685400,2685450,1244800,1244850,3,0,3,0,3,0,9,0,0,0,0,0,0,0,9
755,68542449,2685400,2685450,1244900,1244950,0,0,0,0,3,0,3,0,0,0,3,3,0,6,9
756,68552464,2685500,2685550,1246400,1246450,0,0,3,0,3,0,6,0,3,3,3,3,3,15,21
757,68562516,2685600,2685650,1251600,1251650,0,3,3,0,3,0,9,3,3,0,3,3,0,12,21
758,68562460,2685600,2685650,1246000,1246050,3,3,3,0,3,0,12,4,3,3,3,3,0,16,28
759,68562487,2685600,2685650,1248700,1248750,3,3,3,0,3,0,12,3,3,3,3,3,3,18,30
760,68582449,2685800,2685850,1244900,1244950,3,3,0,0,3,0,9,3,4,0,3,0,0,10,19
761,68582489,2685800,2685850,1248900,1248950,3,0,3,0,0,0,6,3,3,3,3,3,0,15,21
762,68592515,2685900,2685950,1251500,1251550,0,0,3,0,0,0,3,0,0,3,0,0,0,3,6
763,68592462,2685900,2685950,1246200,1246250,0,0,0,0,0,0,0,0,0,0,0,0,0,0,0
764,68602458,2686000,2686050,1245800,1245850,3,0,3,3,3,0,12,3,3,4,3,3,3,19,31
765,68602463,2686000,2686050,1246300,1246350,3,3,0,0,0,0,6,3,3,3,3,0,0,12,18
766,68602461,2686000,2686050,1246100,1246150,0,0,3,3,0,0,6,3,0,3,3,0,0,9,15
767,68602506,2686000,2686050,1250600,1250650,0,0,0,0,0,0,0,0,0,0,0,0,0,0,0
768,68602450,2686000,2686050,1245000,1245050,0,3,3,0,0,0,6,0,3,0,3,0,0,6,12
769,68612460,2686100,2686150,1246000,1246050,3,3,0,3,0,0,9,8,3,3,3,3,3,23,32
770,68612514,2686100,2686150,1251400,1251450,3,0,0,0,0,0,3,6,3,3,0,0,0,12,15
771,68622451,2686200,2686250,1245100,1245150,0,0,0,3,0,0,3,0,3,0,0,0,0,3,6
772,68642457,2686400,2686450,1245700,1245750,3,3,0,0,0,0,6,3,0,3,0,0,0,6,12
773,68652459,2686500,2686550,1245900,1245950,3,0,0,3,0,0,6,3,3,3,0,3,3,15,21
774,68652511,2686500,2686550,1251100,1251150,3,5,0,3,3,0,14,3,0,4,3,3,0,13,27
775,68652508,2686500,2686550,1250800,1250850,3,4,3,7,4,3,24,4,6,7,5,7,5,34,58
776,68652458,2686500,2686550,1245800,1245850,3,3,0,3,3,3,15,3,3,0,3,0,3,12,27
777,68662511,2686600,2686650,1251100,1251150,3,6,3,4,10,3,29,5,5,11,16,10,4,51,80
778,68672502,2686700,2686750,1250200,1250250,3,3,0,3,3,0,12,5,4,3,3,3,0,18,30
779,68672503,2686700,2686750,1250300,1250350,0,0,3,0,0,0,3,3,0,0,0,0,3,6,9
780,68682505,2686800,2686850,1250500,1250550,0,0,3,0,0,0,3,3,0,0,0,0,3,6,9
781,68682459,2686800,2686850,1245900,1245950,3,3,3,3,0,3,15,6,4,8,6,3,0,27,42
782,68682504,2686800,2686850,1250400,1250450,0,0,0,0,0,0,0,0,0,0,0,3,0,3,3
783,68692504,2686900,2686950,1250400,1250450,3,0,3,0,0,0,6,0,3,0,0,0,0,3,9
784,68692503,2686900,2686950,1250300,1250350,3,3,3,0,0,0,9,3,0,3,3,3,0,12,21
785,68702462,2687000,2687050,1246200,1246250,3,3,3,0,3,3,15,4,3,5,0,3,3,18,33
786,68722458,2687200,2687250,1245800,1245850,0,0,0,0,0,0,0,0,0,3,0,0,0,3,3
787,68732502,2687300,2687350,1250200,1250250,3,0,0,0,0,0,3,3,3,0,0,0,0,6,9
788,68742465,2687400,2687450,1246500,1246550,3,3,3,3,0,3,15,3,3,3,3,3,0,15,30
789,68762458,2687600,2687650,1245800,1245850,3,0,0,3,3,0,9,3,0,4,3,3,0,13,22
790,68792451,2687900,2687950,1245100,1245150,0,0,0,0,0,0,0,0,0,0,0,0,0,0,0
791,68932461,2689300,2689350,1246100,1246150,3,3,0,0,0,0,6,0,0,0,0,0,0,0,6
792,68262507,2682600,2682650,1250700,1250750,0,0,0,0,0,0,0,0,0,0,0,0,0,0,0
793,67912488,2679100,2679150,1248800,1248850,0,0,0,0,0,0,0,0,0,0,0,0,3,3,3
794,67802495,2678000,2678050,1249500,1249550,3,3,3,3,3,3,18,0,5,3,3,3,3,17,35
795,67812497,2678100,2678150,1249700,1249750,0,0,0,0,0,0,0,0,0,0,0,0,0,0,0
796,67822485,2678200,2678250,1248500,1248550,0,0,0,0,0,0,0,0,0,0,0,0,3,3,3
797,67822518,2678200,2678250,1251800,1251850,0,0,0,3,0,0,3,0,3,0,3,3,0,9,12
798,67832522,2678300,2678350,1252200,1252250,0,3,3,0,0,3,9,3,3,3,3,3,3,18,27
799,67832494,2678300,2678350,1249400,1249450,3,0,0,0,3,0,6,3,0,0,3,3,0,9,15
800,67852494,2678500,2678550,1249400,1249450,3,7,3,3,0,3,19,3,6,3,0,3,0,15,34
801,67872476,2678700,2678750,1247600,1247650,3,4,3,0,3,0,13,0,4,0,3,3,0,10,23
802,67872475,2678700,2678750,1247500,1247550,0,3,3,0,3,0,9,3,4,3,0,0,0,10,19
803,67872501,2678700,2678750,1250100,1250150,0,0,0,0,0,0,0,3,0,0,0,0,0,3,3
804,67882494,2678800,2678850,1249400,1249450,6,5,0,0,3,0,14,7,3,3,0,3,3,19,33
805,67882488,2678800,2678850,1248800,1248850,3,3,0,3,0,0,9,4,3,3,3,0,0,13,22
806,67882485,2678800,2678850,1248500,1248550,3,6,5,3,3,0,20,3,6,11,6,3,3,32,52
807,67892510,2678900,2678950,1251000,1251050,3,0,3,3,0,0,9,0,3,3,3,0,0,9,18
808,67892483,2678900,2678950,1248300,1248350,3,3,0,0,0,0,6,3,3,3,0,0,0,9,15
809,67892499,2678900,2678950,1249900,1249950,0,3,0,0,0,0,3,3,0,3,0,0,0,6,9
810,67902469,2679000,2679050,1246900,1246950,0,0,3,0,0,0,3,0,3,0,0,0,0,3,6
811,67912473,2679100,2679150,1247300,1247350,3,0,3,3,0,3,12,3,3,0,3,3,3,15,27
812,67912476,2679100,2679150,1247600,1247650,3,6,3,3,4,3,22,4,8,6,5,5,3,31,53
813,67912490,2679100,2679150,1249000,1249050,0,3,3,0,0,0,6,3,3,0,0,0,0,6,12
814,67912517,2679100,2679150,1251700,1251750,0,0,0,0,0,0,0,0,0,0,0,0,0,0,0
815,67912507,2679100,2679150,1250700,1250750,0,3,3,3,0,0,9,3,3,3,0,0,0,9,18
816,67932501,2679300,2679350,1250100,1250150,3,6,7,3,3,0,22,12,13,5,7,3,3,43,65
817,67932478,2679300,2679350,1247800,1247850,4,6,3,3,0,0,16,5,3,5,5,6,4,28,44
818,67932504,2679300,2679350,1250400,1250450,3,3,3,3,0,0,12,3,3,0,3,3,0,12,24
819,67942507,2679400,2679450,1250700,1250750,3,3,3,3,0,0,12,3,3,0,3,3,0,12,24
820,67952509,2679500,2679550,1250900,1250950,4,4,0,3,3,3,17,3,4,4,3,3,3,20,37
821,67952471,2679500,2679550,1247100,1247150,3,4,5,3,3,3,21,3,6,3,3,6,0,21,42
822,67952510,2679500,2679550,1251000,1251050,3,3,3,3,0,3,15,5,4,4,0,3,3,19,34
823,67952480,2679500,2679550,1248000,1248050,3,0,0,0,0,0,3,0,0,0,0,0,0,0,3
824,67962478,2679600,2679650,1247800,1247850,3,3,3,3,3,0,15,7,5,5,9,3,3,32,47
825,67962492,2679600,2679650,1249200,1249250,3,3,0,0,0,0,6,3,3,0,3,0,0,9,15
826,67972478,2679700,2679750,1247800,1247850,3,3,3,3,3,3,18,7,6,3,3,3,3,25,43
827,67972531,2679700,2679750,1253100,1253150,3,6,3,0,0,0,12,6,3,3,0,3,0,15,27
828,67972505,2679700,2679750,1250500,1250550,0,0,3,0,0,0,3,0,0,3,0,0,0,3,6
829,67972530,2679700,2679750,1253000,1253050,3,3,3,0,0,3,12,0,3,0,3,3,3,12,24
830,67982503,2679800,2679850,1250300,1250350,3,0,3,3,3,0,12,0,0,3,0,3,0,6,18
831,67982476,2679800,2679850,1247600,1247650,3,3,3,0,0,0,9,0,3,3,3,0,3,12,21
832,67992506,2679900,2679950,1250600,1250650,3,3,3,3,0,0,12,3,0,0,3,0,0,6,18
833,67992482,2679900,2679950,1248200,1248250,3,3,3,0,0,0,9,3,3,0,0,0,0,6,15
834,67992471,2679900,2679950,1247100,1247150,0,0,0,3,0,0,3,0,0,0,3,0,0,3,6
835,67992470,2679900,2679950,1247000,1247050,3,3,0,0,0,0,6,3,3,3,3,0,0,12,18
836,67992463,2679900,2679950,1246300,1246350,0,0,0,0,0,0,0,0,0,3,0,0,0,3,3
837,68002476,2680000,2680050,1247600,1247650,3,3,3,3,3,0,15,0,3,3,3,3,0,12,27
838,68002496,2680000,2680050,1249600,1249650,0,0,0,0,0,0,0,0,0,3,0,0,0,3,3
839,68012471,2680100,2680150,1247100,1247150,3,4,3,3,0,0,13,3,5,5,3,3,0,19,32
840,68012522,2680100,2680150,1252200,1252250,0,0,0,0,0,0,0,0,0,0,0,0,0,0,0
841,68022488,2680200,2680250,1248800,1248850,0,0,0,0,0,0,0,0,0,0,0,0,0,0,0
842,68042503,2680400,2680450,1250300,1250350,0,3,3,3,0,0,9,3,3,3,3,0,0,12,21
843,68052534,2680500,2680550,1253400,1253450,3,3,0,3,0,0,9,3,0,3,0,0,0,6,15
844,68052502,2680500,2680550,1250200,1250250,3,3,0,0,0,0,6,4,3,0,0,0,3,10,16
845,68062467,2680600,2680650,1246700,1246750,0,3,0,3,0,0,6,3,3,0,3,0,3,12,18
846,68062457,2680600,2680650,1245700,1245750,3,3,3,0,0,0,9,0,3,3,0,0,0,6,15
847,68062533,2680600,2680650,1253300,1253350,3,3,0,0,3,0,9,3,3,0,0,0,0,6,15
848,68062496,2680600,2680650,1249600,1249650,3,0,3,0,0,0,6,3,3,3,0,3,0,12,18
849,68062531,2680600,2680650,1253100,1253150,0,0,0,0,0,0,0,0,0,0,0,0,0,0,0
850,68072464,2680700,2680750,1246400,1246450,3,3,3,0,0,0,9,0,3,3,0,0,0,6,15
851,68072470,2680700,2680750,1247000,1247050,0,3,0,0,0,3,6,3,3,3,0,0,3,12,18
852,68072495,2680700,2680750,1249500,1249550,0,0,0,0,0,0,0,0,0,0,0,0,0,0,0
853,68082498,2680800,2680850,1249800,1249850,0,3,0,0,0,0,3,0,0,3,3,3,0,9,12
854,68082505,2680800,2680850,1250500,1250550,0,3,4,3,0,3,13,3,0,0,3,3,0,9,22
855,68082494,2680800,2680850,1249400,1249450,3,3,3,3,0,0,12,3,3,0,3,3,0,12,24
856,68092502,2680900,2680950,1250200,1250250,3,3,3,0,4,3,16,6,4,3,3,3,3,22,38
857,68092481,2680900,2680950,1248100,1248150,3,3,3,0,0,0,9,4,3,0,0,0,0,7,16
858,68092482,2680900,2680950,1248200,1248250,4,3,0,0,0,0,7,3,3,0,0,0,3,9,16
859,68092524,2680900,2680950,1252400,1252450,3,3,0,3,0,3,12,3,3,0,3,3,3,15,27
860,68092470,2680900,2680950,1247000,1247050,3,0,3,3,5,0,14,3,3,8,6,5,0,25,39
861,68092473,2680900,2680950,1247300,1247350,0,3,0,3,3,0,9,3,3,0,3,0,0,9,18
862,68092532,2680900,2680950,1253200,1253250,3,3,3,3,0,0,12,5,3,0,0,3,0,11,23
863,68092458,2680900,2680950,1245800,1245850,3,3,3,3,3,3,18,3,3,6,3,3,0,18,36
864,68102454,2681000,2681050,1245400,1245450,0,3,0,3,3,0,9,3,3,3,3,0,3,15,24
865,68102473,2681000,2681050,1247300,1247350,6,3,3,3,0,0,15,3,3,7,3,0,3,19,34
866,68102531,2681000,2681050,1253100,1253150,3,5,5,3,5,9,30,5,5,5,10,18,36,79,109
867,68102453,2681000,2681050,1245300,1245350,3,3,3,3,0,3,15,3,3,3,3,3,3,18,33
868,68102501,2681000,2681050,1250100,1250150,3,0,3,3,3,0,12,3,3,3,3,3,0,15,27
869,68102466,2681000,2681050,1246600,1246650,3,4,3,3,0,0,13,5,5,3,3,3,3,22,35
870,68102482,2681000,2681050,1248200,1248250,3,0,3,0,0,0,6,3,3,3,0,0,3,12,18
871,68102530,2681000,2681050,1253000,1253050,8,6,3,3,3,5,28,6,8,8,4,9,3,38,66
872,68112484,2681100,2681150,1248400,1248450,7,3,3,3,0,0,16,3,4,4,0,3,3,17,33
873,68112496,2681100,2681150,1249600,1249650,0,0,0,0,0,0,0,0,0,0,0,0,0,0,0
874,68112497,2681100,2681150,1249700,1249750,3,3,3,3,0,0,12,3,0,0,0,0,0,3,15
875,68122468,2681200,2681250,1246800,1246850,7,3,3,0,3,0,16,3,3,3,3,3,3,18,34
876,68122456,2681200,2681250,1245600,1245650,0,0,0,0,0,3,3,0,0,0,0,0,0,0,3
877,68122431,2681200,2681250,1243100,1243150,3,0,0,0,0,0,3,3,0,3,0,0,0,6,9
878,68122471,2681200,2681250,1247100,1247150,3,4,3,3,3,0,16,3,3,3,0,0,0,9,25
879,68122518,2681200,2681250,1251800,1251850,3,4,0,3,3,3,16,3,7,3,3,5,0,21,37
880,68122425,2681200,2681250,1242500,1242550,0,4,3,3,3,0,13,3,4,3,3,3,3,19,32
881,68122465,2681200,2681250,1246500,1246550,0,0,0,3,3,0,6,0,3,3,3,0,0,9,15
882,68132502,2681300,2681350,1250200,1250250,3,3,0,3,3,3,15,3,3,3,3,0,0,12,27
883,68132431,2681300,2681350,1243100,1243150,3,0,0,0,0,3,6,3,0,3,3,0,3,12,18
884,68132517,2681300,2681350,1251700,1251750,3,0,0,0,0,0,3,0,0,0,0,0,0,0,3
885,68132421,2681300,2681350,1242100,1242150,0,0,3,3,3,3,12,4,3,4,9,3,3,26,38
886,68132467,2681300,2681350,1246700,1246750,3,3,3,3,0,3,15,5,3,3,3,3,0,17,32
887,68132464,2681300,2681350,1246400,1246450,3,0,0,0,0,0,3,3,3,0,0,0,0,6,9
888,68132434,2681300,2681350,1243400,1243450,0,0,0,0,0,0,0,0,0,0,0,0,0,0,0
889,68132509,2681300,2681350,1250900,1250950,0,0,0,0,0,0,0,0,0,0,0,0,0,0,0
890,68142432,2681400,2681450,1243200,1243250,3,3,3,0,3,0,12,0,3,3,0,0,0,6,18
891,68142436,2681400,2681450,1243600,1243650,0,0,0,0,0,0,0,3,0,0,0,0,0,3,3
892,68142494,2681400,2681450,1249400,1249450,0,3,4,3,0,0,10,3,3,4,3,0,0,13,23
893,68152491,2681500,2681550,1249100,1249150,0,0,0,0,0,0,0,3,0,0,0,0,0,3,3
894,68152467,2681500,2681550,1246700,1246750,3,3,3,5,0,0,14,3,3,3,3,3,3,18,32
895,68152532,2681500,2681550,1253200,1253250,3,5,0,3,3,0,14,5,4,3,3,0,0,15,29
896,68162474,2681600,2681650,1247400,1247450,3,3,3,3,0,0,12,3,3,3,3,0,3,15,27
897,68162518,2681600,2681650,1251800,1251850,0,0,0,0,0,0,0,0,0,0,0,0,0,0,0
898,68172463,2681700,2681750,1246300,1246350,3,3,3,0,3,0,12,3,3,3,3,0,3,15,27
899,68172501,2681700,2681750,1250100,1250150,3,0,3,3,0,0,9,3,3,3,3,3,0,15,24
900,68172464,2681700,2681750,1246400,1246450,3,3,3,3,3,0,15,3,4,3,3,0,3,16,31
901,68172431,2681700,2681750,1243100,1243150,3,0,0,3,0,0,6,4,0,0,3,0,0,7,13
902,68172476,2681700,2681750,1247600,1247650,3,3,3,0,0,0,9,0,3,0,3,0,0,6,15
903,68172493,2681700,2681750,1249300,1249350,0,0,0,3,0,0,3,0,3,0,0,0,0,3,6
904,68182493,2681800,2681850,1249300,1249350,4,3,3,0,0,0,10,4,3,0,0,0,0,7,17
905,68182461,2681800,2681850,1246100,1246150,3,3,3,3,0,0,12,3,5,3,3,0,0,14,26
906,68182496,2681800,2681850,1249600,1249650,0,0,0,0,0,0,0,0,0,0,0,0,0,0,0
907,68192476,2681900,2681950,1247600,1247650,0,0,0,0,0,0,0,0,3,0,0,0,0,3,3
908,68192470,2681900,2681950,1247000,1247050,3,3,0,0,0,0,6,0,0,3,3,0,0,6,12
909,68202517,2682000,2682050,1251700,1251750,4,0,0,3,0,0,7,3,3,3,3,0,0,12,19
910,68202482,2682000,2682050,1248200,1248250,3,3,3,3,0,0,12,3,3,0,3,0,0,9,21
911,68202453,2682000,2682050,1245300,1245350,0,0,0,0,0,0,0,0,0,0,0,0,0,0,0
912,68212459,2682100,2682150,1245900,1245950,3,4,0,3,0,0,10,3,3,3,3,0,0,12,22
913,68212519,2682100,2682150,1251900,1251950,3,3,3,0,3,0,12,3,3,3,3,3,3,18,30
914,68212500,2682100,2682150,1250000,1250050,3,3,0,0,0,3,9,3,3,3,3,0,3,15,24
915,68212476,2682100,2682150,1247600,1247650,0,0,0,0,0,0,0,0,0,0,0,0,0,0,0
916,68212495,2682100,2682150,1249500,1249550,4,3,3,0,0,3,13,4,0,0,0,3,0,7,20
917,68212497,2682100,2682150,1249700,1249750,3,3,3,3,0,3,15,3,9,9,4,4,3,32,47
918,68212485,2682100,2682150,1248500,1248550,3,0,3,0,0,0,6,0,3,0,0,0,0,3,9
919,68222454,2682200,2682250,1245400,1245450,0,0,3,0,3,0,6,3,0,3,0,3,0,9,15
920,68222451,2682200,2682250,1245100,1245150,3,0,0,3,0,0,6,3,3,3,0,3,0,12,18
921,68222470,2682200,2682250,1247000,1247050,3,3,3,0,0,3,12,3,3,3,3,3,0,15,27
922,68222496,2682200,2682250,1249600,1249650,3,3,3,0,0,0,9,3,4,0,0,0,0,7,16
923,68232501,2682300,2682350,1250100,1250150,3,3,0,0,0,0,6,3,0,3,0,0,0,6,12
924,68232488,2682300,2682350,1248800,1248850,5,6,0,3,3,0,17,5,3,3,4,3,0,18,35
925,68232434,2682300,2682350,1243400,1243450,3,0,0,0,0,0,3,4,3,0,0,0,0,7,10
926,68232458,2682300,2682350,1245800,1245850,4,3,3,0,0,0,10,3,3,3,3,3,0,15,25
927,68232450,2682300,2682350,1245000,1245050,0,3,0,0,3,0,6,0,3,0,0,3,3,9,15
928,68242521,2682400,2682450,1252100,1252150,3,3,3,0,0,0,9,3,3,3,0,3,0,12,21
929,68242474,2682400,2682450,1247400,1247450,5,3,3,0,0,0,11,3,0,0,0,0,0,3,14
930,68242466,2682400,2682450,1246600,1246650,0,0,0,0,0,0,0,0,0,0,0,0,0,0,0
931,68242503,2682400,2682450,1250300,1250350,3,0,0,0,0,0,3,0,0,0,0,0,0,0,3
932,68252475,2682500,2682550,1247500,1247550,3,0,0,0,0,0,3,3,3,0,0,0,0,6,9
933,68252492,2682500,2682550,1249200,1249250,5,0,3,3,0,0,11,3,0,0,3,0,0,6,17
934,68252438,2682500,2682550,1243800,1243850,3,3,3,3,0,0,12,3,0,3,0,0,0,6,18
935,68252479,2682500,2682550,1247900,1247950,3,0,0,0,0,0,3,0,0,0,0,0,0,0,3
936,68262494,2682600,2682650,1249400,1249450,3,4,3,3,0,0,13,6,3,3,3,3,3,21,34
937,68262513,2682600,2682650,1251300,1251350,3,3,0,3,0,0,9,4,0,3,3,0,0,10,19
938,68262485,2682600,2682650,1248500,1248550,3,3,0,0,0,0,6,0,0,0,0,0,0,0,6
939,68262455,2682600,2682650,1245500,1245550,3,0,0,0,0,0,3,0,0,0,0,0,0,0,3
940,68262524,2682600,2682650,1252400,1252450,3,3,0,0,0,0,6,0,0,0,0,0,0,0,6
941,68272448,2682700,2682750,1244800,1244850,0,0,0,0,0,0,0,0,0,0,0,0,0,0,0
942,68272466,2682700,2682750,1246600,1246650,0,0,3,3,0,3,9,0,3,3,0,0,3,9,18
943,68272523,2682700,2682750,1252300,1252350,3,3,0,0,0,3,9,0,0,0,3,0,3,6,15
944,68272493,2682700,2682750,1249300,1249350,3,3,0,0,0,0,6,3,3,3,0,3,3,15,21
945,68272441,2682700,2682750,1244100,1244150,3,0,0,0,0,0,3,3,0,3,0,0,0,6,9
946,68272490,2682700,2682750,1249000,1249050,3,0,0,3,0,0,6,3,0,0,3,0,0,6,12
947,68272470,2682700,2682750,1247000,1247050,0,0,0,0,0,0,0,0,0,3,0,0,0,3,3
948,68282491,2682800,2682850,1249100,1249150,0,0,3,0,3,0,6,4,0,3,3,3,0,13,19
949,68282439,2682800,2682850,1243900,1243950,3,0,3,3,0,3,12,3,3,3,3,3,3,18,30
950,68282436,2682800,2682850,1243600,1243650,3,0,0,0,0,0,3,3,0,3,0,0,0,6,9
951,68282470,2682800,2682850,1247000,1247050,0,0,3,0,0,0,3,0,0,0,0,0,0,0,3
952,68282438,2682800,2682850,1243800,1243850,3,0,3,0,0,0,6,0,0,0,0,0,0,0,6
953,68292492,2682900,2682950,1249200,1249250,4,3,3,0,0,0,10,3,5,3,3,0,0,14,24
954,68292437,2682900,2682950,1243700,1243750,0,4,3,0,3,0,10,0,3,3,3,0,0,9,19
955,68292427,2682900,2682950,1242700,1242750,3,4,0,0,0,0,7,4,3,0,3,0,3,13,20
956,68292538,2682900,2682950,1253800,1253850,0,0,3,0,0,3,6,3,0,0,3,0,0,6,12
957,68292537,2682900,2682950,1253700,1253750,6,6,12,6,8,3,41,3,21,18,18,10,10,80,121
958,68302498,2683000,2683050,1249800,1249850,3,3,3,0,3,0,12,4,4,0,0,0,3,11,23
959,68302494,2683000,2683050,1249400,1249450,3,4,0,0,0,0,7,4,3,3,3,3,3,19,26
960,68302495,2683000,2683050,1249500,1249550,0,3,3,0,0,0,6,3,0,3,0,0,0,6,12
961,68302525,2683000,2683050,1252500,1252550,3,3,0,3,0,0,9,3,3,0,3,0,0,9,18
962,68302489,2683000,2683050,1248900,1248950,3,3,3,0,0,0,9,3,3,0,3,0,0,9,18
963,68312496,2683100,2683150,1249600,1249650,3,4,4,6,3,0,20,4,7,7,7,3,3,31,51
964,68312437,2683100,2683150,1243700,1243750,0,0,0,0,0,0,0,0,0,0,0,3,0,3,3
965,68322495,2683200,2683250,1249500,1249550,3,3,3,0,0,3,12,5,3,0,6,3,3,20,32
966,68322502,2683200,2683250,1250200,1250250,0,0,3,0,3,0,6,3,0,3,3,0,0,9,15
967,68322504,2683200,2683250,1250400,1250450,3,0,3,0,3,0,9,3,3,3,3,3,3,18,27
968,68332472,2683300,2683350,1247200,1247250,3,3,0,3,0,3,12,3,3,3,3,0,0,12,24
969,68332537,2683300,2683350,1253700,1253750,4,3,3,0,3,0,13,3,3,6,3,3,0,18,31
970,68332486,2683300,2683350,1248600,1248650,3,0,0,3,3,0,9,3,0,3,3,3,3,15,24
971,68332511,2683300,2683350,1251100,1251150,3,3,0,3,0,0,9,3,3,0,3,0,0,9,18
972,68332516,2683300,2683350,1251600,1251650,3,0,3,0,0,0,6,0,3,3,0,0,0,6,12
973,68342521,2683400,2683450,1252100,1252150,0,4,5,3,0,3,15,4,3,6,3,0,0,16,31
974,68342536,2683400,2683450,1253600,1253650,3,5,3,0,0,0,11,5,5,3,0,3,3,19,30
975,68342515,2683400,2683450,1251500,1251550,3,3,3,0,0,0,9,3,3,3,0,3,0,12,21
976,68342484,2683400,2683450,1248400,1248450,0,3,0,0,0,0,3,3,3,0,0,0,0,6,9
977,68342471,2683400,2683450,1247100,1247150,0,0,0,0,0,0,0,0,0,0,0,0,0,0,0
978,68352487,2683500,2683550,1248700,1248750,5,6,3,0,0,0,14,6,9,3,3,3,0,24,38
979,68352538,2683500,2683550,1253800,1253850,3,3,3,0,3,0,12,3,3,3,3,3,3,18,30
980,68352508,2683500,2683550,1250800,1250850,3,3,3,3,0,3,15,3,3,4,3,0,0,13,28
981,68352509,2683500,2683550,1250900,1250950,3,3,5,3,3,0,17,4,3,3,3,3,0,16,33
982,68352519,2683500,2683550,1251900,1251950,3,0,0,0,0,0,3,3,0,0,0,0,0,3,6
983,68362514,2683600,2683650,1251400,1251450,0,4,3,0,0,0,7,4,8,0,3,3,0,18,25
984,68362493,2683600,2683650,1249300,1249350,0,3,3,0,0,3,9,3,0,3,0,0,0,6,15
985,68362500,2683600,2683650,1250000,1250050,0,0,0,0,0,0,0,3,0,0,0,0,0,3,3
986,68362515,2683600,2683650,1251500,1251550,3,3,3,0,0,0,9,3,3,3,5,0,3,17,26
987,68362492,2683600,2683650,1249200,1249250,4,3,0,0,3,0,10,0,3,3,0,3,0,9,19
988,68362496,2683600,2683650,1249600,1249650,0,3,3,3,4,3,16,3,3,11,6,6,3,32,48
989,68372486,2683700,2683750,1248600,1248650,3,0,3,0,3,0,9,3,3,3,3,0,0,12,21
990,68372489,2683700,2683750,1248900,1248950,3,0,3,0,0,0,6,3,3,3,0,0,0,9,15
991,68372534,2683700,2683750,1253400,1253450,3,0,3,0,0,0,6,4,3,3,3,0,0,13,19
992,68372484,2683700,2683750,1248400,1248450,3,3,0,3,3,0,12,3,3,3,3,3,0,15,27
993,68372462,2683700,2683750,1246200,1246250,0,0,0,0,3,0,3,0,0,0,0,3,0,3,6
994,68382511,2683800,2683850,1251100,1251150,5,3,0,3,3,0,14,3,3,3,0,0,3,12,26
995,68382531,2683800,2683850,1253100,1253150,3,0,3,0,0,0,6,0,3,3,0,0,0,6,12
996,68392523,2683900,2683950,1252300,1252350,3,0,0,0,0,0,3,3,0,0,3,0,0,6,9
997,68392510,2683900,2683950,1251000,1251050,3,3,3,3,0,0,12,3,3,3,3,0,0,12,24
998,68402500,2684000,2684050,1250000,1250050,0,0,3,0,0,0,3,0,3,0,0,0,0,3,6
999,68412461,2684100,2684150,1246100,1246150,3,4,3,3,0,0,13,5,4,3,3,3,3,21,34
1000,68412463,2684100,2684150,1246300,1246350,5,5,3,3,0,0,16,3,4,3,3,3,0,16,32
1001,68412510,2684100,2684150,1251000,1251050,0,3,0,0,0,0,3,0,0,3,0,3,3,9,12
1002,68412486,2684100,2684150,1248600,1248650,3,3,3,0,0,3,12,0,4,3,0,0,0,7,19
1003,68412500,2684100,2684150,1250000,1250050,0,0,0,0,0,0,0,0,0,0,0,0,0,0,0
1004,68422470,2684200,2684250,1247000,1247050,3,3,3,3,3,0,15,4,3,3,4,0,0,14,29
1005,68422524,2684200,2684250,1252400,1252450,0,0,0,0,0,0,0,0,3,3,0,3,3,12,12
1006,68432513,2684300,2684350,1251300,1251350,5,4,3,3,3,3,21,4,3,3,3,4,3,20,41
1007,68432456,2684300,2684350,1245600,1245650,3,0,3,3,0,0,9,6,5,3,3,3,3,23,32
1008,68432483,2684300,2684350,1248300,1248350,0,3,3,0,3,0,9,3,3,3,0,3,0,12,21
1009,68432487,2684300,2684350,1248700,1248750,3,3,3,3,3,3,18,3,5,3,5,3,0,19,37
1010,68432519,2684300,2684350,1251900,1251950,3,0,0,3,0,0,6,0,0,3,0,0,3,6,12
1011,68442487,2684400,2684450,1248700,1248750,3,0,3,0,0,3,9,3,3,3,3,0,0,12,21
1012,68442512,2684400,2684450,1251200,1251250,3,3,0,0,3,0,9,3,3,0,3,0,3,12,21
1013,68442475,2684400,2684450,1247500,1247550,3,3,3,3,3,0,15,6,3,3,3,0,0,15,30
1014,68442489,2684400,2684450,1248900,1248950,3,3,3,0,3,0,12,3,3,3,0,0,3,12,24
1015,68452481,2684500,2684550,1248100,1248150,3,0,3,3,0,0,9,3,0,3,3,3,3,15,24
1016,68462453,2684600,2684650,1245300,1245350,11,3,3,3,0,0,20,14,8,4,3,0,3,32,52
1017,68462472,2684600,2684650,1247200,1247250,3,0,3,0,0,0,6,5,3,3,0,3,0,14,20
1018,68462455,2684600,2684650,1245500,1245550,3,0,0,0,0,0,3,0,3,0,0,0,0,3,6
1019,68462479,2684600,2684650,1247900,1247950,3,3,3,3,3,0,15,3,4,5,5,0,0,17,32
1020,68462520,2684600,2684650,1252000,1252050,3,0,0,3,0,0,6,3,3,3,0,0,0,9,15
1021,68462469,2684600,2684650,1246900,1246950,3,7,3,3,3,3,22,5,4,3,4,4,7,27,49
1022,68462519,2684600,2684650,1251900,1251950,0,3,3,3,0,0,9,3,3,0,3,3,0,12,21
1023,68472486,2684700,2684750,1248600,1248650,0,3,0,0,0,0,3,0,0,0,0,0,0,0,3
1024,68482515,2684800,2684850,1251500,1251550,0,5,0,3,0,0,8,3,3,3,3,0,0,12,20
1025,68482479,2684800,2684850,1247900,1247950,3,0,0,0,0,0,3,0,3,0,0,0,3,6,9
1026,68492463,2684900,2684950,1246300,1246350,3,4,3,3,3,0,16,4,5,0,3,3,3,18,34
1027,68492473,2684900,2684950,1247300,1247350,3,0,3,3,0,0,9,3,3,3,3,0,0,12,21
1028,68492484,2684900,2684950,1248400,1248450,3,0,0,0,0,0,3,0,0,0,0,0,0,0,3
1029,68502468,2685000,2685050,1246800,1246850,4,4,3,3,0,0,14,5,3,5,0,0,0,13,27
1030,68502462,2685000,2685050,1246200,1246250,3,3,0,3,0,3,12,3,3,4,3,3,3,19,31
1031,68502519,2685000,2685050,1251900,1251950,3,0,0,0,0,0,3,3,3,0,0,0,3,9,12
1032,68502514,2685000,2685050,1251400,1251450,0,3,3,3,3,3,15,4,4,3,3,3,3,20,35
1033,68502450,2685000,2685050,1245000,1245050,3,0,3,0,0,0,6,3,0,0,3,0,0,6,12
1034,68512465,2685100,2685150,1246500,1246550,0,3,0,3,0,0,6,0,3,0,0,0,0,3,9
1035,68512478,2685100,2685150,1247800,1247850,3,3,3,0,0,0,9,3,0,3,3,0,0,9,18
1036,68512453,2685100,2685150,1245300,1245350,3,0,0,0,0,0,3,3,0,0,0,0,0,3,6
1037,68512518,2685100,2685150,1251800,1251850,3,3,3,3,0,0,12,4,3,0,3,0,0,10,22
1038,68512464,2685100,2685150,1246400,1246450,5,0,3,3,0,0,11,6,3,3,3,3,0,18,29
1039,68512471,2685100,2685150,1247100,1247150,3,3,3,0,0,0,9,0,3,3,0,0,0,6,15
1040,68512476,2685100,2685150,1247600,1247650,3,3,0,3,0,0,9,3,3,3,4,3,7,23,32
1041,68522471,2685200,2685250,1247100,1247150,3,3,0,0,0,0,6,0,3,0,0,0,0,3,9
1042,68532507,2685300,2685350,1250700,1250750,3,3,3,3,0,0,12,3,3,3,3,5,0,17,29
1043,68532513,2685300,2685350,1251300,1251350,3,3,0,0,0,3,9,3,6,3,3,0,0,15,24
1044,68532475,2685300,2685350,1247500,1247550,3,0,3,0,0,0,6,3,3,0,0,0,0,6,12
1045,68532451,2685300,2685350,1245100,1245150,0,0,3,0,0,0,3,0,0,0,0,3,0,3,6
1046,68532449,2685300,2685350,1244900,1244950,0,3,3,0,0,0,6,0,0,3,0,0,0,3,9
1047,68532478,2685300,2685350,1247800,1247850,3,0,0,3,0,0,6,3,0,3,0,0,0,6,12
1048,68542473,2685400,2685450,1247300,1247350,3,0,3,0,0,0,6,3,0,3,0,0,0,6,12
1049,68542516,2685400,2685450,1251600,1251650,0,0,0,0,0,0,0,0,0,0,0,0,0,0,0
1050,68552458,2685500,2685550,1245800,1245850,3,0,0,0,0,0,3,3,0,0,0,0,0,3,6
1051,68562448,2685600,2685650,1244800,1244850,0,0,0,0,0,0,0,0,0,0,0,0,0,0,0
1052,68572447,2685700,2685750,1244700,1244750,3,4,3,0,0,0,10,4,3,3,0,3,0,13,23
1053,68572462,2685700,2685750,1246200,1246250,3,3,0,0,0,0,6,0,3,3,0,0,0,6,12
1054,68602507,2686000,2686050,1250700,1250750,3,5,3,3,0,0,14,3,4,0,0,3,3,13,27
1055,68602454,2686000,2686050,1245400,1245450,0,0,0,0,0,0,0,3,3,0,0,0,0,6,6
1056,68602513,2686000,2686050,1251300,1251350,3,0,0,0,0,0,3,3,0,0,3,0,0,6,9
1057,68602481,2686000,2686050,1248100,1248150,0,3,0,0,0,0,3,0,3,0,0,0,0,3,6
1058,68602503,2686000,2686050,1250300,1250350,0,0,0,0,0,0,0,0,0,0,0,0,0,0,0
1059,68612450,2686100,2686150,1245000,1245050,0,3,3,3,0,0,9,3,3,0,0,0,3,9,18
1060,68632509,2686300,2686350,1250900,1250950,3,0,0,0,0,0,3,3,3,3,0,0,0,9,12
1061,68652462,2686500,2686550,1246200,1246250,0,0,0,0,0,0,0,0,0,3,3,0,0,6,6
1062,68652507,2686500,2686550,1250700,1250750,0,3,3,0,0,0,6,3,3,3,3,3,3,18,24
1063,68652456,2686500,2686550,1245600,1245650,3,0,0,3,0,0,6,0,0,0,3,0,0,3,9
1064,68652503,2686500,2686550,1250300,1250350,3,8,4,3,3,0,21,3,4,3,3,3,0,16,37
1065,68652487,2686500,2686550,1248700,1248750,0,0,0,0,0,0,0,0,0,0,0,0,0,0,0
1066,68662455,2686600,2686650,1245500,1245550,3,3,0,0,0,3,9,3,3,3,4,6,3,22,31
1067,68682456,2686800,2686850,1245600,1245650,3,3,3,0,0,0,9,3,3,3,3,3,0,15,24
1068,68692458,2686900,2686950,1245800,1245850,3,3,4,3,0,0,13,3,3,5,3,0,0,14,27
1069,68692508,2686900,2686950,1250800,1250850,3,0,0,0,3,0,6,0,0,0,3,0,0,3,9
1070,68692511,2686900,2686950,1251100,1251150,3,0,3,0,0,0,6,0,3,0,3,0,0,6,12
1071,68692507,2686900,2686950,1250700,1250750,3,3,0,0,0,0,6,0,3,0,3,0,3,9,15
1072,68722461,2687200,2687250,1246100,1246150,3,0,3,0,3,0,9,3,3,4,4,3,3,20,29
1073,68722457,2687200,2687250,1245700,1245750,3,3,3,0,0,0,9,3,0,3,0,0,3,9,18
1074,68722465,2687200,2687250,1246500,1246550,0,3,3,3,3,0,12,3,3,3,0,3,0,12,24
1075,68732465,2687300,2687350,1246500,1246550,3,3,0,0,0,0,6,4,3,0,3,0,3,13,19
1076,68732460,2687300,2687350,1246000,1246050,0,3,0,0,3,0,6,3,3,3,3,0,0,12,18
1077,68742458,2687400,2687450,1245800,1245850,3,0,3,0,0,0,6,0,3,0,0,0,3,6,12
1078,68762453,2687600,2687650,1245300,1245350,0,0,3,3,3,3,12,0,3,3,3,3,0,12,24
1079,68772456,2687700,2687750,1245600,1245650,3,9,3,6,3,0,24,3,7,12,3,3,3,31,55
1080,68772455,2687700,2687750,1245500,1245550,3,3,3,3,3,3,18,0,3,3,3,3,3,15,33
1081,68782454,2687800,2687850,1245400,1245450,3,3,7,3,3,3,22,4,5,7,7,3,3,29,51
1082,68792454,2687900,2687950,1245400,1245450,3,3,3,3,3,3,18,7,5,3,4,3,0,22,40
1083,68572492,2685700,2685750,1249200,1249250,0,0,0,0,0,0,0,0,0,0,0,0,0,0,0
1084,67782491,2677800,2677850,1249100,1249150,3,4,5,4,3,3,22,7,12,9,17,3,3,51,73
1085,67782493,2677800,2677850,1249300,1249350,3,5,5,6,5,0,24,6,6,8,11,8,3,42,66
1086,67792493,2677900,2677950,1249300,1249350,4,3,5,3,3,3,21,3,5,8,4,3,0,23,44
1087,67802491,2678000,2678050,1249100,1249150,3,0,0,0,0,0,3,0,3,3,0,3,0,9,12
1088,67812492,2678100,2678150,1249200,1249250,0,0,3,0,0,0,3,3,0,3,0,0,0,6,9
1089,67812495,2678100,2678150,1249500,1249550,3,6,3,3,3,3,21,3,4,3,3,6,3,22,43
1090,67812494,2678100,2678150,1249400,1249450,3,5,5,3,3,0,19,6,4,5,3,3,0,21,40
1091,67832521,2678300,2678350,1252100,1252150,3,3,3,0,0,0,9,3,3,4,0,3,0,13,22
1092,67852496,2678500,2678550,1249600,1249650,3,3,3,3,0,0,12,3,3,3,3,3,0,15,27
1093,67862485,2678600,2678650,1248500,1248550,3,3,3,3,0,3,15,3,3,3,3,3,0,15,30
1094,67862509,2678600,2678650,1250900,1250950,0,0,3,0,3,0,6,3,0,3,0,3,0,9,15
1095,67882483,2678800,2678850,1248300,1248350,0,3,0,3,0,0,6,3,3,0,0,0,0,6,12
1096,67882481,2678800,2678850,1248100,1248150,3,3,3,3,0,0,12,3,5,3,3,3,0,17,29
1097,67892486,2678900,2678950,1248600,1248650,3,3,3,3,0,0,12,3,3,5,3,3,0,17,29
1098,67892509,2678900,2678950,1250900,1250950,4,4,7,3,3,3,24,4,7,6,6,7,3,33,57
1099,67892470,2678900,2678950,1247000,1247050,0,3,0,0,0,0,3,0,0,0,0,0,0,0,3
1100,67902472,2679000,2679050,1247200,1247250,5,3,3,3,3,0,17,3,3,3,3,3,0,15,32
1101,67922482,2679200,2679250,1248200,1248250,3,3,0,0,0,0,6,3,3,0,3,0,0,9,15
1102,67922489,2679200,2679250,1248900,1248950,3,3,3,3,3,0,15,4,3,4,3,0,0,14,29
1103,67932471,2679300,2679350,1247100,1247150,3,3,0,0,3,0,9,0,3,3,3,0,4,13,22
1104,67932479,2679300,2679350,1247900,1247950,3,3,3,0,3,0,12,3,8,4,4,4,3,26,38
1105,67932498,2679300,2679350,1249800,1249850,0,0,0,0,0,0,0,0,0,0,3,0,0,3,3
1106,67932514,2679300,2679350,1251400,1251450,3,3,0,0,0,0,6,0,0,0,3,0,0,3,9
1107,67952488,2679500,2679550,1248800,1248850,3,0,0,0,0,0,3,0,0,3,0,0,0,3,6
1108,67962490,2679600,2679650,1249000,1249050,3,0,0,3,0,0,6,0,3,0,0,0,0,3,9
1109,67962470,2679600,2679650,1247000,1247050,7,0,3,0,3,3,16,5,4,3,6,4,0,22,38
1110,67962491,2679600,2679650,1249100,1249150,0,0,0,0,0,0,0,0,0,0,0,0,0,0,0
1111,67962511,2679600,2679650,1251100,1251150,3,5,3,6,0,0,17,3,7,4,3,3,3,23,40
1112,67962486,2679600,2679650,1248600,1248650,3,0,0,0,0,0,3,0,0,0,0,0,0,0,3
1113,67962481,2679600,2679650,1248100,1248150,3,0,0,0,0,0,3,0,0,0,0,0,0,0,3
1114,67972466,2679700,2679750,1246600,1246650,0,3,3,3,0,0,9,0,3,3,3,3,3,15,24
1115,67972469,2679700,2679750,1246900,1246950,7,3,3,0,3,3,19,5,4,3,3,6,0,21,40
1116,67972513,2679700,2679750,1251300,1251350,0,0,0,0,0,0,0,0,0,3,0,0,0,3,3
1117,67982512,2679800,2679850,1251200,1251250,3,0,3,3,3,0,12,0,3,3,3,4,3,16,28
1118,67982490,2679800,2679850,1249000,1249050,0,0,3,0,3,0,6,0,3,0,0,0,0,3,9
1119,68002478,2680000,2680050,1247800,1247850,7,3,3,3,0,0,16,5,5,5,3,3,0,21,37
1120,68002457,2680000,2680050,1245700,1245750,0,3,3,3,0,0,9,3,3,0,3,0,0,9,18
1121,68002503,2680000,2680050,1250300,1250350,3,3,3,0,3,0,12,3,3,3,3,3,0,15,27
1122,68012509,2680100,2680150,1250900,1250950,3,7,7,3,3,0,23,3,4,6,3,0,3,19,42
1123,68012508,2680100,2680150,1250800,1250850,3,3,4,0,3,0,13,3,3,3,3,3,3,18,31
1124,68012496,2680100,2680150,1249600,1249650,3,3,0,0,0,0,6,3,0,0,0,0,0,3,9
1125,68022526,2680200,2680250,1252600,1252650,0,4,0,0,3,3,10,3,0,0,0,0,3,6,16
1126,68022480,2680200,2680250,1248000,1248050,3,3,0,0,3,0,9,3,3,3,3,3,3,18,27
1127,68032484,2680300,2680350,1248400,1248450,3,3,3,0,0,0,9,3,0,0,0,0,0,3,12
1128,68032509,2680300,2680350,1250900,1250950,3,3,3,0,0,0,9,3,3,4,0,0,3,13,22
1129,68032506,2680300,2680350,1250600,1250650,0,3,0,3,0,0,6,0,3,3,3,0,0,9,15
1130,68032526,2680300,2680350,1252600,1252650,3,3,0,0,0,0,6,3,0,3,0,0,0,6,12
1131,68032470,2680300,2680350,1247000,1247050,3,3,3,3,3,0,15,3,3,5,3,3,3,20,35
1132,68042475,2680400,2680450,1247500,1247550,5,3,3,3,3,0,17,4,4,5,3,4,3,23,40
1133,68042529,2680400,2680450,1252900,1252950,3,3,3,3,3,0,15,3,3,3,3,3,0,15,30
1134,68052482,2680500,2680550,1248200,1248250,3,0,3,0,0,0,6,3,0,0,0,0,0,3,9
1135,68052498,2680500,2680550,1249800,1249850,0,3,0,3,0,0,6,0,3,3,0,3,0,9,15
1136,68062480,2680600,2680650,1248000,1248050,5,3,3,3,0,0,14,8,5,3,0,3,0,19,33
1137,68062465,2680600,2680650,1246500,1246550,3,0,0,0,0,0,3,3,0,0,0,0,0,3,6
1138,68062518,2680600,2680650,1251800,1251850,0,3,5,3,4,3,18,3,3,3,9,3,3,24,42
1139,68062528,2680600,2680650,1252800,1252850,3,3,0,0,0,0,6,3,3,3,3,0,0,12,18
1140,68062419,2680600,2680650,1241900,1241950,0,0,0,0,0,0,0,0,0,0,0,0,0,0,0
1141,68062468,2680600,2680650,1246800,1246850,0,0,0,0,0,0,0,3,3,0,0,0,0,6,6
1142,68082501,2680800,2680850,1250100,1250150,3,0,3,0,0,0,6,0,0,3,0,0,0,3,9
1143,68082454,2680800,2680850,1245400,1245450,0,3,3,3,3,0,12,4,3,3,0,0,0,10,22
1144,68082502,2680800,2680850,1250200,1250250,3,5,3,3,3,3,20,0,3,3,3,0,3,12,32
1145,68082486,2680800,2680850,1248600,1248650,5,3,3,0,0,0,11,6,3,4,3,3,3,22,33
1146,68082522,2680800,2680850,1252200,1252250,4,3,3,0,3,0,13,3,3,3,3,3,3,18,31
1147,68082527,2680800,2680850,1252700,1252750,0,0,0,0,0,0,0,3,3,0,0,0,0,6,6
1148,68082485,2680800,2680850,1248500,1248550,3,0,3,0,3,0,9,3,3,4,3,0,0,13,22
1149,68092499,2680900,2680950,1249900,1249950,3,3,0,0,3,0,9,3,3,0,0,3,0,9,18
1150,68092464,2680900,2680950,1246400,1246450,3,3,8,3,5,0,22,3,3,0,5,8,12,31,53
1151,68092520,2680900,2680950,1252000,1252050,0,0,0,0,0,0,0,3,0,0,0,3,0,6,6
1152,68092478,2680900,2680950,1247800,1247850,6,3,4,0,3,0,16,5,3,3,3,0,0,14,30
1153,68092480,2680900,2680950,1248000,1248050,3,0,3,0,0,0,6,3,3,0,0,3,0,9,15
1154,68092460,2680900,2680950,1246000,1246050,0,0,0,0,0,0,0,0,0,0,0,0,0,0,0
1155,68102485,2681000,2681050,1248500,1248550,3,3,3,3,3,0,15,3,3,3,0,3,3,15,30
1156,68102469,2681000,2681050,1246900,1246950,3,0,3,0,0,0,6,4,3,4,3,0,3,17,23
1157,68102462,2681000,2681050,1246200,1246250,0,0,0,0,0,0,0,0,0,0,0,0,0,0,0
1158,68112426,2681100,2681150,1242600,1242650,0,3,0,0,0,3,6,0,0,3,0,0,3,6,12
1159,68112471,2681100,2681150,1247100,1247150,3,3,3,0,0,0,9,0,3,3,3,0,0,9,18
1160,68112481,2681100,2681150,1248100,1248150,3,0,0,0,0,0,3,0,0,0,0,0,0,0,3
1161,68112524,2681100,2681150,1252400,1252450,3,3,3,3,3,3,18,3,3,5,5,3,3,22,40
1162,68122423,2681200,2681250,1242300,1242350,0,0,0,0,0,0,0,3,0,0,0,0,0,3,3
1163,68122462,2681200,2681250,1246200,1246250,0,0,0,0,0,3,3,0,0,0,3,0,0,3,6
1164,68132519,2681300,2681350,1251900,1251950,3,3,0,0,0,3,9,3,3,0,0,3,3,12,21
1165,68132500,2681300,2681350,1250000,1250050,0,3,3,0,0,3,9,3,3,3,3,0,0,12,21
1166,68132423,2681300,2681350,1242300,1242350,4,3,6,3,3,3,22,6,5,3,3,3,3,23,45
1167,68142498,2681400,2681450,1249800,1249850,0,0,3,3,0,0,6,3,3,3,3,3,0,15,21
1168,68142519,2681400,2681450,1251900,1251950,0,0,0,0,3,0,3,0,0,3,0,3,3,9,12
1169,68142510,2681400,2681450,1251000,1251050,0,0,0,0,0,0,0,0,0,0,0,0,0,0,0
1170,68142423,2681400,2681450,1242300,1242350,0,0,0,0,0,0,0,0,0,0,0,0,0,0,0
1171,68142457,2681400,2681450,1245700,1245750,3,5,8,0,3,3,22,6,3,3,4,3,3,22,44
1172,68152476,2681500,2681550,1247600,1247650,3,3,0,3,0,0,9,0,3,0,0,0,0,3,12
1173,68152495,2681500,2681550,1249500,1249550,3,3,3,0,0,0,9,0,3,0,0,0,0,3,12
1174,68152458,2681500,2681550,1245800,1245850,3,0,0,0,0,0,3,0,3,0,0,0,0,3,6
1175,68162479,2681600,2681650,1247900,1247950,6,3,3,3,0,0,15,6,5,3,0,3,3,20,35
1176,68172434,2681700,2681750,1243400,1243450,4,3,0,0,0,0,7,3,0,0,3,0,0,6,13
1177,68182482,2681800,2681850,1248200,1248250,3,4,3,0,3,0,13,4,3,3,3,4,0,17,30
1178,68182501,2681800,2681850,1250100,1250150,3,3,3,0,3,0,12,4,3,0,3,3,0,13,25
1179,68182479,2681800,2681850,1247900,1247950,4,3,3,0,0,0,10,4,3,3,3,0,0,13,23
1180,68182499,2681800,2681850,1249900,1249950,3,3,0,0,0,0,6,5,3,3,0,0,3,14,20
1181,68192440,2681900,2681950,1244000,1244050,0,3,3,0,0,0,6,3,3,3,3,0,0,12,18
1182,68192500,2681900,2681950,1250000,1250050,3,3,4,3,0,0,13,6,6,4,0,3,0,19,32
1183,68192516,2681900,2681950,1251600,1251650,3,0,3,0,0,0,6,3,0,3,3,3,3,15,21
1184,68192481,2681900,2681950,1248100,1248150,10,13,11,8,3,0,45,7,7,15,9,7,3,48,93
1185,68202463,2682000,2682050,1246300,1246350,3,0,0,0,0,0,3,0,3,0,3,3,0,9,12
1186,68212492,2682100,2682150,1249200,1249250,0,3,3,0,0,0,6,0,3,3,0,0,0,6,12
1187,68212481,2682100,2682150,1248100,1248150,7,6,4,0,3,0,20,3,3,3,0,0,0,9,29
1188,68212490,2682100,2682150,1249000,1249050,7,8,3,3,3,3,27,8,4,4,5,3,4,28,55
1189,68212439,2682100,2682150,1243900,1243950,0,3,3,0,0,0,6,0,3,0,0,0,3,6,12
1190,68212478,2682100,2682150,1247800,1247850,0,0,0,0,0,0,0,0,0,0,0,3,0,3,3
1191,68222443,2682200,2682250,1244300,1244350,0,0,0,4,3,0,7,3,0,3,3,3,5,17,24
1192,68222481,2682200,2682250,1248100,1248150,3,3,0,3,0,0,9,0,0,3,3,0,0,6,15
1193,68222497,2682200,2682250,1249700,1249750,5,0,3,3,3,0,14,4,3,3,3,0,0,13,27
1194,68222438,2682200,2682250,1243800,1243850,3,3,0,3,3,0,12,4,3,3,3,3,0,16,28
1195,68232498,2682300,2682350,1249800,1249850,3,3,3,0,0,0,9,3,3,3,3,0,0,12,21
1196,68232474,2682300,2682350,1247400,1247450,0,3,3,3,0,0,9,3,0,0,3,0,3,9,18
1197,68232437,2682300,2682350,1243700,1243750,0,3,0,3,3,0,9,3,3,3,5,3,3,20,29
1198,68232523,2682300,2682350,1252300,1252350,3,3,0,3,3,0,12,3,3,3,0,0,3,12,24
1199,68242522,2682400,2682450,1252200,1252250,0,3,3,3,3,3,15,3,3,5,3,3,0,17,32
1200,68242438,2682400,2682450,1243800,1243850,0,3,3,0,0,0,6,3,0,0,3,0,0,6,12
1201,68242430,2682400,2682450,1243000,1243050,3,3,3,3,0,0,12,3,3,3,3,0,0,12,24
1202,68242445,2682400,2682450,1244500,1244550,3,3,3,0,0,0,9,3,3,3,0,0,0,9,18
1203,68252440,2682500,2682550,1244000,1244050,3,0,0,3,0,0,6,0,0,0,0,3,0,3,9
1204,68252513,2682500,2682550,1251300,1251350,0,3,0,0,0,0,3,5,3,3,0,0,3,14,17
1205,68252453,2682500,2682550,1245300,1245350,3,3,0,3,3,0,12,3,0,3,3,3,0,12,24
1206,68252486,2682500,2682550,1248600,1248650,3,4,3,0,0,0,10,3,3,0,3,3,3,15,25
1207,68252462,2682500,2682550,1246200,1246250,3,0,0,0,0,0,3,0,0,0,3,3,0,6,9
1208,68252469,2682500,2682550,1246900,1246950,0,3,0,0,0,0,3,0,3,0,0,0,3,6,9
1209,68252460,2682500,2682550,1246000,1246050,0,3,0,3,0,0,6,0,3,3,0,0,0,6,12
1210,68252439,2682500,2682550,1243900,1243950,3,0,3,0,0,0,6,0,0,0,0,0,3,3,9
1211,68252464,2682500,2682550,1246400,1246450,0,0,0,0,0,0,0,0,3,0,0,0,0,3,3
1212,68262500,2682600,2682650,1250000,1250050,3,0,3,3,3,0,12,3,0,5,0,3,0,11,23
1213,68262451,2682600,2682650,1245100,1245150,0,3,0,0,0,3,6,3,0,0,3,3,3,12,18
1214,68262453,2682600,2682650,1245300,1245350,0,3,0,0,0,0,3,0,3,0,0,3,0,6,9
1215,68272492,2682700,2682750,1249200,1249250,3,7,3,5,3,3,24,4,5,4,10,7,4,34,58
1216,68272517,2682700,2682750,1251700,1251750,3,3,0,3,0,0,9,3,0,3,0,3,0,9,18
1217,68272427,2682700,2682750,1242700,1242750,0,4,3,0,0,0,7,3,0,3,3,0,0,9,16
1218,68282494,2682800,2682850,1249400,1249450,3,3,3,3,3,0,15,4,4,3,3,4,3,21,36
1219,68282511,2682800,2682850,1251100,1251150,3,3,3,3,3,0,15,0,0,3,0,0,0,3,18
1220,68282515,2682800,2682850,1251500,1251550,4,3,3,0,3,0,13,4,3,3,3,3,0,16,29
1221,68282492,2682800,2682850,1249200,1249250,3,3,3,3,0,0,12,3,3,0,0,0,0,6,18
1222,68282467,2682800,2682850,1246700,1246750,3,3,3,3,3,0,15,3,3,5,0,0,3,14,29
1223,68282528,2682800,2682850,1252800,1252850,0,0,0,0,0,0,0,3,0,0,0,0,0,3,3
1224,68292534,2682900,2682950,1253400,1253450,0,3,0,0,0,0,3,0,3,0,0,0,0,3,6
1225,68292476,2682900,2682950,1247600,1247650,0,0,0,0,0,0,0,0,0,0,0,0,0,0,0
1226,68292482,2682900,2682950,1248200,1248250,3,3,3,0,0,0,9,3,0,0,0,0,0,3,12
1227,68292470,2682900,2682950,1247000,1247050,0,0,3,3,3,0,9,0,0,3,3,0,0,6,15
1228,68292468,2682900,2682950,1246800,1246850,0,0,0,0,0,0,0,0,0,0,0,0,0,0,0
1229,68292478,2682900,2682950,1247800,1247850,0,0,3,0,0,0,3,0,3,0,0,0,0,3,6
1230,68302504,2683000,2683050,1250400,1250450,3,3,3,0,0,0,9,3,0,0,0,0,0,3,12
1231,68302530,2683000,2683050,1253000,1253050,3,0,0,3,3,3,12,3,3,3,3,3,0,15,27
1232,68302527,2683000,2683050,1252700,1252750,3,3,3,0,4,3,16,3,3,0,3,3,3,15,31
1233,68302519,2683000,2683050,1251900,1251950,0,0,3,3,0,0,6,3,3,0,3,0,0,9,15
1234,68312493,2683100,2683150,1249300,1249350,3,3,3,0,0,0,9,0,0,0,0,0,0,0,9
1235,68312497,2683100,2683150,1249700,1249750,3,3,3,3,3,3,18,6,0,3,3,3,3,18,36
1236,68312476,2683100,2683150,1247600,1247650,0,0,0,0,0,0,0,0,0,3,0,0,0,3,3
1237,68312494,2683100,2683150,1249400,1249450,0,3,3,0,0,0,6,0,3,0,3,0,0,6,12
1238,68312523,2683100,2683150,1252300,1252350,3,3,3,0,3,0,12,3,3,0,3,0,0,9,21
1239,68312534,2683100,2683150,1253400,1253450,0,0,0,0,0,0,0,0,0,0,0,0,0,0,0
1240,68322507,2683200,2683250,1250700,1250750,4,3,3,0,3,0,13,3,3,3,3,3,3,18,31
1241,68322538,2683200,2683250,1253800,1253850,4,3,4,3,0,0,14,3,3,3,3,3,3,18,32
1242,68322531,2683200,2683250,1253100,1253150,7,6,5,3,3,3,27,8,9,7,4,3,3,34,61
1243,68322486,2683200,2683250,1248600,1248650,4,3,0,3,3,0,13,0,3,3,3,0,3,12,25
1244,68322521,2683200,2683250,1252100,1252150,0,3,3,0,0,0,6,3,3,3,3,0,3,15,21
1245,68332494,2683300,2683350,1249400,1249450,3,3,3,3,3,0,15,3,3,3,5,3,0,17,32
1246,68332538,2683300,2683350,1253800,1253850,3,3,4,3,0,0,13,3,5,3,3,3,0,17,30
1247,68332508,2683300,2683350,1250800,1250850,3,3,0,0,0,0,6,3,3,0,0,0,0,6,12
1248,68332489,2683300,2683350,1248900,1248950,4,3,3,3,0,0,13,3,3,3,3,3,3,18,31
1249,68332531,2683300,2683350,1253100,1253150,3,0,3,0,0,0,6,3,0,3,3,0,0,9,15
1250,68342433,2683400,2683450,1243300,1243350,0,0,0,0,0,0,0,0,0,0,0,0,0,0,0
1251,68342540,2683400,2683450,1254000,1254050,3,0,0,0,0,0,3,3,0,0,0,0,0,3,6
1252,68342482,2683400,2683450,1248200,1248250,3,3,0,0,0,0,6,0,3,0,3,0,3,9,15
1253,68342522,2683400,2683450,1252200,1252250,4,0,3,4,3,0,14,3,5,3,3,5,3,22,36
1254,68352500,2683500,2683550,1250000,1250050,0,0,0,0,0,0,0,0,0,0,3,3,0,6,6
1255,68352525,2683500,2683550,1252500,1252550,3,3,0,0,0,0,6,3,0,0,3,0,0,6,12
1256,68352477,2683500,2683550,1247700,1247750,3,3,3,3,0,0,12,3,0,0,3,3,0,9,21
1257,68352497,2683500,2683550,1249700,1249750,3,3,3,3,3,3,18,5,3,3,3,3,3,20,38
1258,68352490,2683500,2683550,1249000,1249050,5,3,3,0,0,3,14,6,4,3,4,3,0,20,34
1259,68352480,2683500,2683550,1248000,1248050,0,0,3,3,4,4,14,0,3,4,6,5,10,28,42
1260,68362481,2683600,2683650,1248100,1248150,0,0,3,0,0,0,3,3,5,0,0,0,0,8,11
1261,68362523,2683600,2683650,1252300,1252350,3,3,5,3,10,7,31,3,3,7,13,17,24,67,98
1262,68362476,2683600,2683650,1247600,1247650,0,0,3,0,0,0,3,0,3,3,0,0,0,6,9
1263,68362518,2683600,2683650,1251800,1251850,0,3,0,3,0,0,6,3,4,3,3,0,0,13,19
1264,68372482,2683700,2683750,1248200,1248250,3,3,0,3,0,0,9,0,0,0,3,0,0,3,12
1265,68372527,2683700,2683750,1252700,1252750,3,0,3,3,0,0,9,3,0,3,0,0,0,6,15
1266,68372483,2683700,2683750,1248300,1248350,3,4,3,0,0,0,10,0,3,3,3,3,3,15,25
1267,68372507,2683700,2683750,1250700,1250750,3,3,3,3,3,0,15,6,3,3,0,3,3,18,33
1268,68372469,2683700,2683750,1246900,1246950,0,0,3,0,0,0,3,0,3,0,0,0,0,3,6
1269,68372531,2683700,2683750,1253100,1253150,3,5,3,3,0,0,14,4,3,3,3,3,0,16,30
1270,68372516,2683700,2683750,1251600,1251650,3,0,3,0,0,0,6,0,3,3,0,0,0,6,12
1271,68382532,2683800,2683850,1253200,1253250,3,3,0,3,3,0,12,6,3,0,3,0,0,12,24
1272,68382512,2683800,2683850,1251200,1251250,0,3,0,3,0,0,6,4,3,0,3,3,0,13,19
1273,68382535,2683800,2683850,1253500,1253550,3,0,0,0,0,0,3,3,3,3,3,3,0,15,18
1274,68382513,2683800,2683850,1251300,1251350,3,3,5,8,10,12,41,0,0,4,14,28,41,87,128
1275,68382526,2683800,2683850,1252600,1252650,3,0,0,3,0,0,6,0,3,3,0,0,0,6,12
1276,68382466,2683800,2683850,1246600,1246650,0,3,0,3,3,0,9,0,3,3,0,3,0,9,18
1277,68382491,2683800,2683850,1249100,1249150,3,4,3,0,0,3,13,3,3,3,3,0,0,12,25
1278,68392465,2683900,2683950,1246500,1246550,4,3,4,3,0,0,14,3,5,0,3,0,0,11,25
1279,68392526,2683900,2683950,1252600,1252650,0,0,0,0,0,0,0,3,0,0,0,0,0,3,3
1280,68402490,2684000,2684050,1249000,1249050,3,3,3,3,0,3,15,3,0,3,3,3,0,12,27
1281,68402531,2684000,2684050,1253100,1253150,0,0,0,0,0,0,0,0,0,0,0,0,0,0,0
1282,68402511,2684000,2684050,1251100,1251150,3,3,3,0,3,0,12,3,0,3,4,4,3,17,29
1283,68402464,2684000,2684050,1246400,1246450,3,3,5,3,0,0,14,3,4,4,0,0,3,14,28
1284,68402514,2684000,2684050,1251400,1251450,0,3,4,3,3,0,13,6,3,3,3,0,3,18,31
1285,68402467,2684000,2684050,1246700,1246750,0,0,0,0,0,0,0,0,3,0,0,0,0,3,3
1286,68412483,2684100,2684150,1248300,1248350,0,3,0,0,0,0,3,0,3,3,0,3,0,9,12
1287,68422514,2684200,2684250,1251400,1251450,3,3,0,0,3,3,12,3,0,3,3,0,3,12,24
1288,68422511,2684200,2684250,1251100,1251150,6,3,0,0,0,3,12,3,0,3,3,3,3,15,27
1289,68422476,2684200,2684250,1247600,1247650,0,3,3,0,0,0,6,3,5,0,0,3,0,11,17
1290,68422454,2684200,2684250,1245400,1245450,5,0,0,0,0,0,5,3,3,0,0,0,0,6,11
1291,68422479,2684200,2684250,1247900,1247950,0,3,0,0,0,0,3,0,3,0,0,0,0,3,6
1292,68432518,2684300,2684350,1251800,1251850,3,0,3,0,0,0,6,3,0,3,0,0,3,9,15
1293,68432475,2684300,2684350,1247500,1247550,3,5,0,3,3,0,14,3,3,4,3,0,3,16,30
1294,68442454,2684400,2684450,1245400,1245450,6,3,3,3,3,0,18,6,5,3,5,3,3,25,43
1295,68442473,2684400,2684450,1247300,1247350,3,0,3,3,3,0,12,3,0,3,3,0,0,9,21
1296,68442490,2684400,2684450,1249000,1249050,0,0,0,0,0,0,0,0,0,0,0,0,0,0,0
1297,68452482,2684500,2684550,1248200,1248250,0,0,3,3,0,0,6,0,3,3,3,0,0,9,15
1298,68472513,2684700,2684750,1251300,1251350,4,3,3,8,0,0,18,4,5,9,5,3,0,26,44
1299,68472478,2684700,2684750,1247800,1247850,3,4,3,3,0,0,13,3,3,5,3,3,0,17,30
1300,68482461,2684800,2684850,1246100,1246150,7,6,3,3,4,0,23,3,3,4,3,4,3,20,43
1301,68482472,2684800,2684850,1247200,1247250,3,3,0,3,0,0,9,3,3,3,0,0,0,9,18
1302,68492509,2684900,2684950,1250900,1250950,0,0,3,0,0,0,3,0,3,0,0,3,0,6,9
1303,68492462,2684900,2684950,1246200,1246250,3,0,3,3,0,0,9,3,0,3,0,0,0,6,15
1304,68492460,2684900,2684950,1246000,1246050,3,3,3,3,0,0,12,5,3,3,3,3,0,17,29
1305,68492483,2684900,2684950,1248300,1248350,3,3,0,3,3,0,12,3,3,3,3,0,0,12,24
1306,68492516,2684900,2684950,1251600,1251650,3,0,0,0,3,0,6,0,0,3,3,0,0,6,12
1307,68502477,2685000,2685050,1247700,1247750,0,3,3,3,0,0,9,3,3,3,0,3,0,12,21
1308,68502509,2685000,2685050,1250900,1250950,0,3,0,3,0,0,6,0,3,3,0,0,0,6,12
1309,68502459,2685000,2685050,1245900,1245950,0,0,0,0,0,0,0,0,0,0,0,0,0,0,0
1310,68502517,2685000,2685050,1251700,1251750,5,5,3,3,3,3,22,5,6,7,6,3,3,30,52
1311,68512472,2685100,2685150,1247200,1247250,0,0,3,3,0,0,6,0,0,3,3,0,0,6,12
1312,68512452,2685100,2685150,1245200,1245250,0,0,3,0,0,3,6,3,0,3,0,0,0,6,12
1313,68522461,2685200,2685250,1246100,1246150,3,3,3,0,0,0,9,5,3,3,3,3,3,20,29
1314,68522449,2685200,2685250,1244900,1244950,0,3,3,3,0,0,9,4,0,3,3,3,0,13,22
1315,68532471,2685300,2685350,1247100,1247150,3,0,0,0,3,0,6,0,0,0,0,0,3,3,9
1316,68532448,2685300,2685350,1244800,1244850,3,0,0,0,0,0,3,0,0,0,0,0,0,0,3
1317,68542467,2685400,2685450,1246700,1246750,3,3,3,3,0,0,12,0,3,3,3,3,0,12,24
1318,68562464,2685600,2685650,1246400,1246450,0,0,0,0,0,0,0,0,3,0,0,0,0,3,3
1319,68562504,2685600,2685650,1250400,1250450,0,0,0,0,0,0,0,0,0,0,0,0,0,0,0
1320,68562508,2685600,2685650,1250800,1250850,3,3,3,3,3,0,15,3,3,3,0,3,0,12,27
1321,68592450,2685900,2685950,1245000,1245050,0,0,0,0,0,0,0,0,0,0,0,0,0,0,0
1322,68612458,2686100,2686150,1245800,1245850,3,3,3,0,0,0,9,3,3,3,3,0,0,12,21
1323,68622508,2686200,2686250,1250800,1250850,3,0,0,3,0,0,6,0,0,0,3,3,0,6,12
1324,68632508,2686300,2686350,1250800,1250850,0,0,0,3,0,0,3,4,3,3,0,3,3,16,19
1325,68632512,2686300,2686350,1251200,1251250,3,3,3,0,3,0,12,4,4,3,3,3,3,20,32
1326,68642459,2686400,2686450,1245900,1245950,0,0,3,0,0,0,3,3,3,0,0,0,3,9,12
1327,68642511,2686400,2686450,1251100,1251150,3,3,0,3,0,0,9,3,0,0,0,0,0,3,12
1328,68642451,2686400,2686450,1245100,1245150,0,0,0,3,0,0,3,0,3,0,0,0,0,3,6
1329,68662459,2686600,2686650,1245900,1245950,3,3,0,0,0,0,6,3,3,3,0,0,0,9,15
1330,68662510,2686600,2686650,1251000,1251050,0,0,0,3,0,0,3,0,3,0,3,3,0,9,12
1331,68672506,2686700,2686750,1250600,1250650,3,0,0,7,4,0,14,3,3,3,5,4,3,21,35
1332,68672460,2686700,2686750,1246000,1246050,3,3,3,3,0,0,12,4,3,3,4,3,3,20,32
1333,68682510,2686800,2686850,1251000,1251050,3,3,0,3,3,3,15,4,4,4,5,3,5,25,40
1334,68692461,2686900,2686950,1246100,1246150,6,6,3,3,3,0,21,4,5,9,8,5,3,34,55
1335,68702465,2687000,2687050,1246500,1246550,3,3,0,0,0,0,6,3,0,3,0,0,0,6,12
1336,68702456,2687000,2687050,1245600,1245650,3,0,0,0,0,3,6,0,3,0,0,0,3,6,12
1337,68712455,2687100,2687150,1245500,1245550,3,0,3,3,3,0,12,3,3,3,0,0,0,9,21
1338,68712512,2687100,2687150,1251200,1251250,3,3,0,0,0,0,6,3,0,0,3,0,0,6,12
1339,68732454,2687300,2687350,1245400,1245450,0,0,0,0,0,0,0,0,0,0,0,0,0,0,0
1340,68742464,2687400,2687450,1246400,1246450,0,3,0,0,0,0,3,0,3,0,0,0,0,3,6
1341,68752461,2687500,2687550,1246100,1246150,3,0,3,3,0,0,9,3,3,4,3,3,0,16,25
1342,68772462,2687700,2687750,1246200,1246250,3,3,0,3,0,0,9,3,0,3,3,3,0,12,21
1343,68812456,2688100,2688150,1245600,1245650,0,0,0,0,0,0,0,0,0,0,0,0,0,0,0
1344,67772465,2677700,2677750,1246500,1246550,0,0,0,3,0,0,3,3,0,0,0,0,3,6,9
1345,67772493,2677700,2677750,1249300,1249350,6,3,3,3,3,3,21,3,5,4,5,4,4,25,46
1346,67782497,2677800,2677850,1249700,1249750,3,3,0,0,0,0,6,3,3,0,0,3,3,12,18
1347,67802496,2678000,2678050,1249600,1249650,3,0,0,0,0,0,3,3,0,0,0,0,0,3,6
1348,67842489,2678400,2678450,1248900,1248950,3,3,3,3,3,0,15,3,3,3,3,3,0,15,30
1349,67852513,2678500,2678550,1251300,1251350,0,0,0,0,0,0,0,0,0,0,0,0,0,0,0
1350,67862510,2678600,2678650,1251000,1251050,0,3,3,0,3,0,9,3,6,0,4,0,0,13,22
1351,67872484,2678700,2678750,1248400,1248450,0,0,3,3,0,3,9,3,3,3,3,0,0,12,21
1352,67872487,2678700,2678750,1248700,1248750,4,5,3,3,0,3,18,4,3,3,4,3,0,17,35
1353,67872512,2678700,2678750,1251200,1251250,3,3,0,0,0,0,6,3,0,0,3,3,3,12,18
1354,67872498,2678700,2678750,1249800,1249850,0,0,0,0,0,0,0,0,0,0,0,0,0,0,0
1355,67882478,2678800,2678850,1247800,1247850,0,4,3,0,4,3,14,4,3,4,3,3,3,20,34
1356,67892514,2678900,2678950,1251400,1251450,3,4,5,4,5,6,27,4,7,7,13,18,29,78,105
1357,67892518,2678900,2678950,1251800,1251850,3,0,0,0,0,3,6,3,0,3,0,0,0,6,12
1358,67892487,2678900,2678950,1248700,1248750,3,3,4,3,5,3,21,4,5,5,4,7,4,29,50
1359,67892493,2678900,2678950,1249300,1249350,3,3,0,3,3,3,15,4,0,3,3,3,0,13,28
1360,67902510,2679000,2679050,1251000,1251050,0,3,3,3,0,3,12,0,4,4,3,3,0,14,26
1361,67902480,2679000,2679050,1248000,1248050,3,3,3,0,0,3,12,3,3,3,3,3,0,15,27
1362,67902479,2679000,2679050,1247900,1247950,3,8,4,3,3,3,24,4,8,5,4,6,4,31,55
1363,67902500,2679000,2679050,1250000,1250050,3,3,3,0,0,0,9,4,4,4,0,0,0,12,21
1364,67902496,2679000,2679050,1249600,1249650,0,0,0,0,0,0,0,0,0,0,0,0,0,0,0
1365,67912492,2679100,2679150,1249200,1249250,3,3,3,0,5,0,14,3,3,3,4,4,4,21,35
1366,67912471,2679100,2679150,1247100,1247150,3,3,0,0,0,0,6,3,0,0,3,0,0,6,12
1367,67932508,2679300,2679350,1250800,1250850,3,3,3,3,0,0,12,3,0,3,3,3,3,15,27
1368,67942508,2679400,2679450,1250800,1250850,6,0,0,0,0,0,6,3,3,0,3,0,0,9,15
1369,67952491,2679500,2679550,1249100,1249150,3,3,0,0,3,0,9,3,0,0,0,0,0,3,12
1370,67952466,2679500,2679550,1246600,1246650,3,3,0,3,0,0,9,0,3,3,3,3,0,12,21
1371,67962469,2679600,2679650,1246900,1246950,4,3,5,3,0,3,18,3,3,3,3,3,3,18,36
1372,67962473,2679600,2679650,1247300,1247350,3,0,3,3,3,0,12,0,0,3,3,3,0,9,21
1373,68002475,2680000,2680050,1247500,1247550,3,6,3,3,0,3,18,4,5,3,3,0,3,18,36
1374,68002511,2680000,2680050,1251100,1251150,0,3,0,3,0,0,6,0,0,3,3,0,0,6,12
1375,68012487,2680100,2680150,1248700,1248750,5,4,0,4,3,0,16,4,3,3,0,3,3,16,32
1376,68012507,2680100,2680150,1250700,1250750,3,3,0,3,0,0,9,3,3,3,0,0,0,9,18
1377,68012477,2680100,2680150,1247700,1247750,0,0,0,0,0,0,0,0,0,0,0,0,0,0,0
1378,68022482,2680200,2680250,1248200,1248250,3,0,3,0,0,0,6,0,0,3,0,3,3,9,15
1379,68022531,2680200,2680250,1253100,1253150,3,3,3,0,0,0,9,3,3,0,0,0,0,6,15
1380,68022469,2680200,2680250,1246900,1246950,3,3,0,3,3,0,12,3,0,3,3,0,0,9,21
1381,68032504,2680300,2680350,1250400,1250450,3,3,3,3,0,0,12,0,0,3,3,3,0,9,21
1382,68042471,2680400,2680450,1247100,1247150,3,3,0,3,3,0,12,6,8,3,3,0,0,20,32
1383,68042500,2680400,2680450,1250000,1250050,0,0,0,3,0,0,3,3,3,3,0,0,0,9,12
1384,68042461,2680400,2680450,1246100,1246150,3,3,3,3,0,3,15,3,4,4,0,5,3,19,34
1385,68052464,2680500,2680550,1246400,1246450,3,0,0,0,0,0,3,3,0,3,0,0,0,6,9
1386,68062497,2680600,2680650,1249700,1249750,0,4,3,3,0,0,10,3,4,3,3,3,0,16,26
1387,68062469,2680600,2680650,1246900,1246950,3,3,3,0,0,0,9,0,3,0,3,0,0,6,15
1388,68062530,2680600,2680650,1253000,1253050,0,0,0,0,0,0,0,3,0,0,0,0,0,3,3
1389,68062508,2680600,2680650,1250800,1250850,0,0,3,0,0,0,3,0,3,0,0,0,0,3,6
1390,68072486,2680700,2680750,1248600,1248650,3,0,3,3,0,0,9,5,3,0,0,3,3,14,23
1391,68072455,2680700,2680750,1245500,1245550,0,3,3,0,0,0,6,3,3,0,3,3,0,12,18
1392,68072487,2680700,2680750,1248700,1248750,0,3,0,3,3,0,9,3,0,0,3,0,0,6,15
1393,68082464,2680800,2680850,1246400,1246450,8,4,3,3,0,0,18,8,3,0,3,0,0,14,32
1394,68082497,2680800,2680850,1249700,1249750,3,0,3,0,3,0,9,0,3,0,3,0,0,6,15
1395,68082526,2680800,2680850,1252600,1252650,0,3,3,0,0,0,6,3,4,0,0,3,0,10,16
1396,68092501,2680900,2680950,1250100,1250150,0,0,3,0,3,0,6,0,3,3,0,0,0,6,12
1397,68092467,2680900,2680950,1246700,1246750,0,4,3,0,0,0,7,5,3,3,3,0,0,14,21
1398,68102458,2681000,2681050,1245800,1245850,0,0,3,0,3,0,6,0,3,3,3,0,0,9,15
1399,68112501,2681100,2681150,1250100,1250150,3,3,4,4,0,0,14,3,3,4,3,0,3,16,30
1400,68112454,2681100,2681150,1245400,1245450,3,3,3,3,0,3,15,3,0,3,3,0,0,9,24
1401,68112519,2681100,2681150,1251900,1251950,0,0,0,0,3,0,3,3,3,0,3,3,0,12,15
1402,68112457,2681100,2681150,1245700,1245750,6,7,4,8,3,3,31,4,8,7,10,17,25,71,102
1403,68112493,2681100,2681150,1249300,1249350,0,0,0,0,0,0,0,0,0,0,0,0,0,0,0
1404,68112458,2681100,2681150,1245800,1245850,5,5,3,3,4,3,23,4,9,4,11,9,6,43,66
1405,68112459,2681100,2681150,1245900,1245950,3,3,3,3,3,0,15,0,3,3,3,3,0,12,27
1406,68112489,2681100,2681150,1248900,1248950,3,3,3,0,0,0,9,3,0,0,0,0,0,3,12
1407,68122491,2681200,2681250,1249100,1249150,3,3,3,0,0,3,12,3,0,3,3,0,0,9,21
1408,68122427,2681200,2681250,1242700,1242750,3,3,3,0,0,0,9,3,3,3,0,0,0,9,18
1409,68132428,2681300,2681350,1242800,1242850,0,0,3,3,0,0,6,0,0,3,0,0,0,3,9
1410,68132498,2681300,2681350,1249800,1249850,3,3,0,0,0,3,9,3,3,3,3,3,3,18,27
1411,68132518,2681300,2681350,1251800,1251850,3,3,0,0,3,0,9,5,3,4,3,0,0,15,24
1412,68132458,2681300,2681350,1245800,1245850,3,4,3,0,3,3,16,3,7,3,3,3,0,19,35
1413,68132462,2681300,2681350,1246200,1246250,0,0,0,0,0,0,0,0,0,0,0,0,0,0,0
1414,68142480,2681400,2681450,1248000,1248050,5,3,3,0,3,0,14,5,3,3,3,0,3,17,31
1415,68142477,2681400,2681450,1247700,1247750,3,0,0,0,0,0,3,3,0,3,0,0,0,6,9
1416,68142472,2681400,2681450,1247200,1247250,0,3,0,3,3,0,9,3,3,3,3,3,0,15,24
1417,68142476,2681400,2681450,1247600,1247650,5,3,3,0,3,0,14,6,3,0,0,3,0,12,26
1418,68142521,2681400,2681450,1252100,1252150,3,0,3,0,0,0,6,3,0,0,3,0,0,6,12
1419,68142430,2681400,2681450,1243000,1243050,0,0,0,0,0,0,0,0,0,0,0,0,0,0,0
1420,68142537,2681400,2681450,1253700,1253750,0,0,0,0,0,0,0,0,0,0,0,0,0,0,0
1421,68152470,2681500,2681550,1247000,1247050,3,4,3,0,3,0,13,5,8,3,3,3,0,22,35
1422,68152498,2681500,2681550,1249800,1249850,3,4,3,3,0,3,16,4,6,3,3,3,3,22,38
1423,68152432,2681500,2681550,1243200,1243250,0,0,3,0,0,3,6,3,3,3,0,0,0,9,15
1424,68152462,2681500,2681550,1246200,1246250,3,3,0,3,3,0,12,3,3,3,3,0,3,15,27
1425,68152511,2681500,2681550,1251100,1251150,0,0,0,0,0,0,0,0,0,0,0,0,0,0,0
1426,68162459,2681600,2681650,1245900,1245950,3,3,3,0,0,0,9,3,0,3,0,0,0,6,15
1427,68162531,2681600,2681650,1253100,1253150,3,3,3,0,0,3,12,3,3,3,0,0,0,9,21
1428,68162423,2681600,2681650,1242300,1242350,0,3,3,0,0,0,6,0,3,3,0,0,0,6,12
1429,68162517,2681600,2681650,1251700,1251750,3,0,3,3,0,3,12,3,3,3,3,0,0,12,24
1430,68162467,2681600,2681650,1246700,1246750,3,3,0,3,0,0,9,3,3,3,3,0,0,12,21
1431,68172466,2681700,2681750,1246600,1246650,3,4,3,3,3,0,16,4,3,4,3,0,0,14,30
1432,68172473,2681700,2681750,1247300,1247350,12,8,3,3,3,3,32,9,7,12,5,0,3,36,68
1433,68172479,2681700,2681750,1247900,1247950,4,3,3,3,3,0,16,5,3,4,3,3,0,18,34
1434,68172500,2681700,2681750,1250000,1250050,3,3,0,3,3,0,12,3,3,3,3,0,0,12,24
1435,68172461,2681700,2681750,1246100,1246150,0,0,0,0,0,0,0,3,3,3,3,0,0,12,12
1436,68172494,2681700,2681750,1249400,1249450,0,0,0,0,0,0,0,0,0,0,0,0,0,0,0
1437,68182516,2681800,2681850,1251600,1251650,3,0,3,0,3,0,9,0,3,3,0,0,3,9,18
1438,68182491,2681800,2681850,1249100,1249150,3,3,3,0,0,0,9,3,0,0,0,0,0,3,12
1439,68182466,2681800,2681850,1246600,1246650,0,3,0,0,3,0,6,0,3,0,3,0,0,6,12
1440,68182488,2681800,2681850,1248800,1248850,3,3,3,3,3,0,15,3,4,3,3,3,0,16,31
1441,68192475,2681900,2681950,1247500,1247550,0,3,3,3,0,0,9,3,0,0,0,3,0,6,15
1442,68192502,2681900,2681950,1250200,1250250,3,3,3,3,0,0,12,5,3,4,3,0,3,18,30
1443,68192483,2681900,2681950,1248300,1248350,3,0,3,0,0,0,6,0,0,0,0,0,0,0,6
1444,68192491,2681900,2681950,1249100,1249150,3,3,3,3,0,0,12,0,0,3,0,3,0,6,18
1445,68192494,2681900,2681950,1249400,1249450,0,0,0,0,0,0,0,0,0,0,3,0,0,3,3
1446,68192464,2681900,2681950,1246400,1246450,3,3,3,0,0,0,9,3,3,3,0,0,3,12,21
1447,68202471,2682000,2682050,1247100,1247150,5,3,3,3,3,3,20,4,4,3,3,3,3,20,40
1448,68202460,2682000,2682050,1246000,1246050,0,0,3,0,0,0,3,3,3,0,3,0,0,9,12
1449,68202465,2682000,2682050,1246500,1246550,0,0,0,0,0,0,0,0,0,0,0,0,0,0,0
1450,68202490,2682000,2682050,1249000,1249050,3,3,0,3,0,0,9,3,3,3,3,0,0,12,21
1451,68202503,2682000,2682050,1250300,1250350,3,0,0,0,0,0,3,3,0,3,0,0,0,6,9
1452,68202492,2682000,2682050,1249200,1249250,3,3,0,0,0,0,6,3,0,0,3,0,0,6,12
1453,68212455,2682100,2682150,1245500,1245550,3,3,0,3,3,0,12,0,3,3,3,0,0,9,21
1454,68212522,2682100,2682150,1252200,1252250,0,3,0,0,0,0,3,3,3,3,0,3,0,12,15
1455,68212463,2682100,2682150,1246300,1246350,0,4,0,0,0,0,4,3,3,0,0,0,0,6,10
1456,68212470,2682100,2682150,1247000,1247050,0,0,3,0,0,0,3,0,0,0,0,0,3,3,6
1457,68222463,2682200,2682250,1246300,1246350,3,3,0,3,0,0,9,4,3,3,0,0,3,13,22
1458,68222483,2682200,2682250,1248300,1248350,3,3,0,0,0,0,6,3,3,0,0,0,0,6,12
1459,68222434,2682200,2682250,1243400,1243450,3,3,0,3,3,3,15,0,3,3,3,5,0,14,29
1460,68222432,2682200,2682250,1243200,1243250,6,11,6,15,7,8,53,6,14,19,20,33,38,130,183
1461,68232455,2682300,2682350,1245500,1245550,0,0,0,0,0,0,0,0,0,3,0,0,0,3,3
1462,68232497,2682300,2682350,1249700,1249750,0,0,0,0,0,0,0,0,0,0,0,0,3,3,3
1463,68232432,2682300,2682350,1243200,1243250,0,3,3,0,3,0,9,0,7,4,0,3,0,14,23
1464,68232479,2682300,2682350,1247900,1247950,0,3,3,0,0,0,6,3,3,0,0,0,0,6,12
1465,68232463,2682300,2682350,1246300,1246350,0,0,0,0,0,0,0,0,0,0,0,0,0,0,0
1466,68242429,2682400,2682450,1242900,1242950,0,3,0,3,3,0,9,3,3,6,3,3,0,18,27
1467,68242481,2682400,2682450,1248100,1248150,3,3,3,0,3,0,12,6,3,3,0,0,0,12,24
1468,68252494,2682500,2682550,1249400,1249450,9,3,3,0,0,3,18,4,4,3,3,3,3,20,38
1469,68252507,2682500,2682550,1250700,1250750,0,3,0,0,0,0,3,0,3,0,3,0,0,6,9
1470,68252493,2682500,2682550,1249300,1249350,3,5,3,3,0,0,14,4,3,3,0,0,3,13,27
1471,68252476,2682500,2682550,1247600,1247650,3,3,3,0,0,0,9,3,0,3,0,0,0,6,15
1472,68252463,2682500,2682550,1246300,1246350,3,0,0,3,0,0,6,0,0,3,3,3,0,9,15
1473,68262433,2682600,2682650,1243300,1243350,3,0,3,0,0,0,6,0,4,3,0,0,0,7,13
1474,68262511,2682600,2682650,1251100,1251150,3,3,3,3,0,3,15,4,0,3,3,0,3,13,28
1475,68262499,2682600,2682650,1249900,1249950,3,0,0,0,3,3,9,3,0,3,0,3,0,9,18
1476,68262450,2682600,2682650,1245000,1245050,0,0,3,0,0,0,3,0,0,0,0,3,0,3,6
1477,68272496,2682700,2682750,1249600,1249650,3,0,0,0,0,0,3,3,0,3,0,0,0,6,9
1478,68272514,2682700,2682750,1251400,1251450,0,0,0,0,0,0,0,0,0,0,0,0,0,0,0
1479,68272460,2682700,2682750,1246000,1246050,3,3,0,3,0,0,9,0,3,3,3,0,3,12,21
1480,68272500,2682700,2682750,1250000,1250050,3,3,3,3,3,3,18,5,5,7,6,3,3,29,47
1481,68272464,2682700,2682750,1246400,1246450,0,3,0,0,0,0,3,3,3,3,0,0,0,9,12
1482,68272487,2682700,2682750,1248700,1248750,0,0,0,0,0,0,0,0,0,0,0,0,0,0,0
1483,68272509,2682700,2682750,1250900,1250950,0,3,3,3,0,0,9,3,0,4,3,3,3,16,25
1484,68272505,2682700,2682750,1250500,1250550,3,3,0,3,0,0,9,0,3,3,0,3,0,9,18
1485,68272533,2682700,2682750,1253300,1253350,3,0,0,0,0,0,3,3,3,0,0,0,0,6,9
1486,68282469,2682800,2682850,1246900,1246950,0,3,3,3,0,0,9,0,3,3,0,0,0,6,15
1487,68282523,2682800,2682850,1252300,1252350,3,3,0,3,0,0,9,3,0,3,0,0,0,6,15
1488,68282517,2682800,2682850,1251700,1251750,3,3,0,0,0,0,6,3,0,0,3,0,0,6,12
1489,68282531,2682800,2682850,1253100,1253150,3,3,3,0,0,0,9,0,3,0,0,0,0,3,12
1490,68282505,2682800,2682850,1250500,1250550,3,3,3,0,0,3,12,3,3,0,3,0,0,9,21
1491,68292494,2682900,2682950,1249400,1249450,3,3,3,0,3,0,12,3,3,0,0,0,0,6,18
1492,68292529,2682900,2682950,1252900,1252950,3,3,3,3,0,0,12,0,3,3,3,0,0,9,21
1493,68292511,2682900,2682950,1251100,1251150,3,3,0,0,3,0,9,3,3,0,0,3,0,9,18
1494,68292501,2682900,2682950,1250100,1250150,3,3,3,3,0,3,15,3,3,3,3,0,3,15,30
1495,68292467,2682900,2682950,1246700,1246750,0,0,0,0,0,0,0,0,0,0,0,0,0,0,0
1496,68302434,2683000,2683050,1243400,1243450,3,3,0,3,3,3,15,3,3,3,3,3,0,15,30
1497,68302436,2683000,2683050,1243600,1243650,0,0,0,3,0,0,3,3,0,0,0,0,0,3,6
1498,68302511,2683000,2683050,1251100,1251150,0,0,0,0,0,0,0,0,0,0,0,0,0,0,0
1499,68312513,2683100,2683150,1251300,1251350,3,3,0,0,0,0,6,0,3,0,0,0,3,6,12
1500,68312492,2683100,2683150,1249200,1249250,0,0,3,0,0,0,3,3,0,3,0,0,0,6,9
1501,68312475,2683100,2683150,1247500,1247550,3,3,5,3,0,0,14,3,3,7,3,3,0,19,33
1502,68322523,2683200,2683250,1252300,1252350,3,0,3,0,0,0,6,3,0,3,0,0,0,6,12
1503,68322535,2683200,2683250,1253500,1253550,0,0,0,0,0,0,0,0,0,0,0,0,0,0,0
1504,68322483,2683200,2683250,1248300,1248350,0,3,0,0,0,0,3,3,3,3,0,0,3,12,15
1505,68332488,2683300,2683350,1248800,1248850,3,3,3,3,3,3,18,3,3,3,0,3,0,12,30
1506,68332525,2683300,2683350,1252500,1252550,3,3,3,0,3,0,12,3,3,0,0,0,0,6,18
1507,68332433,2683300,2683350,1243300,1243350,0,0,0,0,0,0,0,3,0,0,0,0,0,3,3
1508,68342491,2683400,2683450,1249100,1249150,3,3,11,5,6,3,31,6,20,8,12,15,3,64,95
1509,68352476,2683500,2683550,1247600,1247650,3,0,5,3,0,0,11,3,3,3,3,0,0,12,23
1510,68352532,2683500,2683550,1253200,1253250,0,3,3,0,0,3,9,3,0,3,3,3,0,12,21
1511,68352536,2683500,2683550,1253600,1253650,0,3,0,0,0,0,3,0,0,3,0,0,0,3,6
1512,68352518,2683500,2683550,1251800,1251850,3,3,0,3,0,0,9,3,3,0,3,3,3,15,24
1513,68362483,2683600,2683650,1248300,1248350,4,3,5,3,3,3,21,6,6,6,3,3,3,27,48
1514,68362529,2683600,2683650,1252900,1252950,5,3,3,0,0,0,11,5,3,3,3,0,3,17,28
1515,68362505,2683600,2683650,1250500,1250550,3,0,3,3,3,0,12,3,3,3,3,3,0,15,27
1516,68372485,2683700,2683750,1248500,1248550,3,3,3,0,0,0,9,4,3,0,3,0,0,10,19
1517,68372532,2683700,2683750,1253200,1253250,3,3,0,0,0,0,6,3,3,3,0,0,3,12,18
1518,68372467,2683700,2683750,1246700,1246750,3,0,0,0,0,3,6,0,0,0,0,0,0,0,6
1519,68372468,2683700,2683750,1246800,1246850,0,3,3,0,0,0,6,3,0,0,0,0,0,3,9
1520,68372490,2683700,2683750,1249000,1249050,0,0,3,0,3,0,6,4,0,3,3,0,0,10,16
1521,68382510,2683800,2683850,1251000,1251050,3,4,3,3,3,3,19,5,3,3,3,0,3,17,36
1522,68382509,2683800,2683850,1250900,1250950,5,3,3,3,0,0,14,7,5,3,4,3,0,22,36
1523,68382463,2683800,2683850,1246300,1246350,0,0,0,0,0,0,0,3,3,0,0,0,0,6,6
1524,68382518,2683800,2683850,1251800,1251850,3,0,3,0,0,0,6,0,3,0,0,0,0,3,9
1525,68382467,2683800,2683850,1246700,1246750,0,0,0,0,0,0,0,0,0,0,0,0,0,0,0
1526,68392466,2683900,2683950,1246600,1246650,0,0,3,0,0,0,3,0,0,3,0,0,0,3,6
1527,68392488,2683900,2683950,1248800,1248850,3,3,3,3,3,3,18,3,0,3,0,3,0,9,27
1528,68392493,2683900,2683950,1249300,1249350,3,3,3,3,3,0,15,3,0,3,3,0,0,9,24
1529,68392463,2683900,2683950,1246300,1246350,3,3,4,0,3,3,16,3,7,5,10,3,3,31,47
1530,68392458,2683900,2683950,1245800,1245850,0,0,0,3,0,0,3,0,0,3,3,0,0,6,9
1531,68392497,2683900,2683950,1249700,1249750,0,0,3,3,0,0,6,0,3,3,0,3,0,9,15
1532,68402470,2684000,2684050,1247000,1247050,3,0,3,0,3,0,9,3,3,3,0,3,0,12,21
1533,68412462,2684100,2684150,1246200,1246250,3,3,3,4,0,0,13,3,5,3,3,3,0,17,30
1534,68412530,2684100,2684150,1253000,1253050,3,3,3,0,0,0,9,3,4,4,0,3,3,17,26
1535,68412531,2684100,2684150,1253100,1253150,3,0,3,0,0,0,6,0,0,0,0,0,0,0,6
1536,68412456,2684100,2684150,1245600,1245650,3,3,3,0,0,0,9,3,4,3,4,0,3,17,26
1537,68412502,2684100,2684150,1250200,1250250,0,3,3,3,0,0,9,3,0,0,0,0,0,3,12
1538,68412515,2684100,2684150,1251500,1251550,3,4,0,3,3,0,13,6,4,4,3,3,3,23,36
1539,68412488,2684100,2684150,1248800,1248850,3,3,3,0,0,0,9,3,3,3,3,0,0,12,21
1540,68412465,2684100,2684150,1246500,1246550,3,3,3,0,3,0,12,3,6,3,3,0,0,15,27
1541,68422486,2684200,2684250,1248600,1248650,5,3,3,0,0,0,11,0,5,4,0,3,0,12,23
1542,68422457,2684200,2684250,1245700,1245750,4,4,4,3,0,0,15,4,3,3,5,3,3,21,36
1543,68422465,2684200,2684250,1246500,1246550,3,3,3,0,0,0,9,0,0,3,0,0,0,3,12
1544,68422487,2684200,2684250,1248700,1248750,3,0,3,0,0,3,9,3,4,3,0,0,3,13,22
1545,68422522,2684200,2684250,1252200,1252250,3,0,0,3,0,0,6,0,0,3,0,0,0,3,9
1546,68432481,2684300,2684350,1248100,1248150,3,3,3,0,0,0,9,3,3,3,0,0,0,9,18
1547,68432461,2684300,2684350,1246100,1246150,4,0,0,0,0,3,7,3,0,0,3,3,0,9,16
1548,68432521,2684300,2684350,1252100,1252150,0,0,0,0,0,0,0,0,3,0,0,0,0,3,3
1549,68442514,2684400,2684450,1251400,1251450,3,3,3,3,0,0,12,3,3,0,0,3,0,9,21
1550,68442525,2684400,2684450,1252500,1252550,5,4,3,0,0,0,12,4,3,3,3,0,0,13,25
1551,68452468,2684500,2684550,1246800,1246850,5,3,3,3,3,0,17,3,3,3,0,0,0,9,26
1552,68452475,2684500,2684550,1247500,1247550,3,0,0,0,0,0,3,3,0,3,0,0,0,6,9
1553,68452480,2684500,2684550,1248000,1248050,3,3,3,3,0,0,12,3,3,3,3,0,0,12,24
1554,68452457,2684500,2684550,1245700,1245750,3,4,6,5,4,10,32,5,5,10,10,23,14,67,99
1555,68462509,2684600,2684650,1250900,1250950,3,3,0,0,0,0,6,7,3,3,3,3,0,19,25
1556,68462515,2684600,2684650,1251500,1251550,3,0,3,3,0,0,9,3,0,3,3,3,0,12,21
1557,68462470,2684600,2684650,1247000,1247050,3,3,0,0,3,3,12,0,4,0,3,0,0,7,19
1558,68462474,2684600,2684650,1247400,1247450,3,3,0,0,3,3,12,3,3,0,3,3,3,15,27
1559,68462508,2684600,2684650,1250800,1250850,0,3,0,0,0,0,3,0,0,0,3,0,3,6,9
1560,68472461,2684700,2684750,1246100,1246150,0,3,5,0,3,0,11,3,4,4,3,3,3,20,31
1561,68472511,2684700,2684750,1251100,1251150,3,3,3,3,0,3,15,3,0,3,4,3,3,16,31
1562,68472470,2684700,2684750,1247000,1247050,3,0,3,0,3,0,9,3,3,3,3,0,0,12,21
1563,68472518,2684700,2684750,1251800,1251850,3,3,5,3,3,3,20,4,3,5,5,5,3,25,45
1564,68482468,2684800,2684850,1246800,1246850,3,3,3,0,0,0,9,3,0,6,3,0,0,12,21
1565,68482477,2684800,2684850,1247700,1247750,3,0,0,0,3,0,6,3,3,3,0,3,0,12,18
1566,68482455,2684800,2684850,1245500,1245550,3,4,4,0,0,0,11,3,3,3,0,3,0,12,23
1567,68492513,2684900,2684950,1251300,1251350,3,5,3,3,0,3,17,5,5,5,3,3,3,24,41
1568,68492456,2684900,2684950,1245600,1245650,0,3,0,0,0,0,3,0,3,3,0,0,0,6,9
1569,68492451,2684900,2684950,1245100,1245150,3,0,0,3,0,0,6,3,0,3,0,0,0,6,12
1570,68502465,2685000,2685050,1246500,1246550,3,3,3,6,7,3,25,0,4,4,17,19,25,69,94
1571,68502451,2685000,2685050,1245100,1245150,3,3,3,0,0,0,9,3,3,3,0,0,0,9,18
1572,68512467,2685100,2685150,1246700,1246750,3,0,0,0,0,0,3,3,3,0,0,0,0,6,9
1573,68512512,2685100,2685150,1251200,1251250,3,3,0,0,0,3,9,0,4,0,3,3,0,10,19
1574,68512507,2685100,2685150,1250700,1250750,0,0,0,0,0,0,0,0,0,0,0,0,0,0,0
1575,68522458,2685200,2685250,1245800,1245850,3,3,3,3,0,3,15,3,0,3,3,0,3,12,27
1576,68522457,2685200,2685250,1245700,1245750,3,0,0,0,0,0,3,0,3,0,0,0,0,3,6
1577,68522467,2685200,2685250,1246700,1246750,3,0,0,3,0,3,9,0,3,3,0,0,0,6,15
1578,68522515,2685200,2685250,1251500,1251550,3,0,0,0,0,0,3,3,0,0,0,0,0,3,6
1579,68522508,2685200,2685250,1250800,1250850,3,3,4,0,3,0,13,3,4,3,3,3,0,16,29
1580,68532481,2685300,2685350,1248100,1248150,3,3,0,0,0,3,9,3,0,3,0,3,0,9,18
1581,68532474,2685300,2685350,1247400,1247450,0,0,0,0,0,0,0,0,0,0,0,0,0,0,0
1582,68532464,2685300,2685350,1246400,1246450,4,3,3,0,3,3,16,5,3,3,3,3,0,17,33
1583,68542521,2685400,2685450,1252100,1252150,3,0,3,0,0,0,6,0,3,0,0,0,0,3,9
1584,68542460,2685400,2685450,1246000,1246050,3,0,0,0,0,0,3,0,0,3,3,0,0,6,9
1585,68542482,2685400,2685450,1248200,1248250,3,3,0,0,0,0,6,3,0,3,3,0,0,9,15
1586,68572449,2685700,2685750,1244900,1244950,0,0,3,0,0,0,3,0,0,0,0,3,0,3,6
1587,68592455,2685900,2685950,1245500,1245550,0,0,0,3,3,0,6,0,3,0,0,0,0,3,9
1588,68592452,2685900,2685950,1245200,1245250,0,4,3,3,3,3,16,0,3,3,8,12,14,40,56
1589,68592463,2685900,2685950,1246300,1246350,0,0,0,0,0,0,0,0,0,0,0,0,0,0,0
1590,68612509,2686100,2686150,1250900,1250950,3,3,3,0,3,3,15,4,3,7,4,3,3,24,39
1591,68622455,2686200,2686250,1245500,1245550,3,0,3,3,0,0,9,3,0,3,0,3,0,9,18
1592,68622510,2686200,2686250,1251000,1251050,0,3,0,0,0,0,3,3,3,0,0,0,0,6,9
1593,68622458,2686200,2686250,1245800,1245850,3,3,0,0,3,0,9,3,3,3,3,3,0,15,24
1594,68622450,2686200,2686250,1245000,1245050,0,0,0,0,0,0,0,0,0,0,0,0,0,0,0
1595,68632461,2686300,2686350,1246100,1246150,3,0,3,3,0,0,9,3,3,4,0,0,3,13,22
1596,68542513,2685400,2685450,1251300,1251350,0,0,0,0,0,0,0,0,0,0,0,0,0,0,0
1597,68312519,2683100,2683150,1251900,1251950,3,3,3,3,0,0,12,3,3,3,3,3,0,15,27
1598,68012476,2680100,2680150,1247600,1247650,0,0,0,0,0,0,0,0,0,0,0,0,0,0,0
1599,68422526,2684200,2684250,1252600,1252650,0,0,3,0,0,0,3,3,0,0,0,0,0,3,6
1600,68702464,2687000,2687050,1246400,1246450,0,0,0,0,0,0,0,0,0,0,0,0,0,0,0
1601,67942498,2679400,2679450,1249800,1249850,0,0,3,0,3,0,6,0,3,3,0,0,0,6,12
1602,68672507,2686700,2686750,1250700,1250750,3,3,3,0,3,0,12,3,3,4,6,3,3,22,34
1603,68672511,2686700,2686750,1251100,1251150,8,3,3,3,3,3,23,10,3,3,4,4,3,27,50
1604,68682502,2686800,2686850,1250200,1250250,0,0,3,3,0,0,6,3,3,3,3,3,0,15,21
1605,68682501,2686800,2686850,1250100,1250150,0,0,0,0,0,0,0,0,0,0,0,0,0,0,0
1606,68692459,2686900,2686950,1245900,1245950,0,3,0,3,3,0,9,3,3,0,3,0,0,9,18
1607,68712456,2687100,2687150,1245600,1245650,4,3,4,3,3,0,17,4,3,3,0,5,3,18,35
1608,68712504,2687100,2687150,1250400,1250450,5,3,3,3,0,0,14,7,3,6,3,0,0,19,33
1609,68722460,2687200,2687250,1246000,1246050,0,3,0,0,3,0,6,3,3,3,0,0,0,9,15
1610,68732464,2687300,2687350,1246400,1246450,0,3,0,0,0,0,3,0,3,0,0,0,3,6,9
1611,68742455,2687400,2687450,1245500,1245550,3,3,3,3,3,0,15,6,3,3,4,3,0,19,34
1612,68752453,2687500,2687550,1245300,1245350,0,0,3,3,3,3,12,0,3,3,3,0,0,9,21
1613,68772459,2687700,2687750,1245900,1245950,0,3,0,0,3,0,6,0,3,0,3,0,0,6,12
1614,68772453,2687700,2687750,1245300,1245350,3,3,5,0,0,3,14,3,3,3,3,3,3,18,32
1615,68782456,2687800,2687850,1245600,1245650,3,4,5,4,3,3,22,3,11,11,7,6,0,38,60
1616,68802454,2688000,2688050,1245400,1245450,3,3,0,0,0,0,6,3,3,0,0,3,0,9,15
1617,68202437,2682000,2682050,1243700,1243750,0,0,3,0,0,0,3,0,0,3,0,0,0,3,6
1618,68282536,2682800,2682850,1253600,1253650,3,3,0,0,0,0,6,3,0,3,0,3,0,9,15
1619,68142463,2681400,2681450,1246300,1246350,0,0,0,0,0,0,0,0,3,0,0,0,0,3,3
1620,68602488,2686000,2686050,1248800,1248850,0,0,0,3,0,0,3,0,0,0,0,0,0,0,3
1621,67782522,2677800,2677850,1252200,1252250,0,0,0,0,0,0,0,0,0,0,0,0,0,0,0
1622,67792472,2677900,2677950,1247200,1247250,0,3,0,0,0,0,3,3,0,0,0,0,0,3,6
1623,67812490,2678100,2678150,1249000,1249050,0,3,3,3,0,0,9,3,0,0,3,3,0,9,18
1624,67812485,2678100,2678150,1248500,1248550,0,3,0,0,0,0,3,0,0,0,0,0,0,0,3
1625,67822496,2678200,2678250,1249600,1249650,0,3,0,0,0,0,3,0,3,0,0,0,0,3,6
1626,67822492,2678200,2678250,1249200,1249250,7,3,4,3,0,0,17,5,3,0,0,0,0,8,25
1627,67822495,2678200,2678250,1249500,1249550,10,8,6,3,3,3,33,13,5,4,3,3,3,31,64
1628,67822487,2678200,2678250,1248700,1248750,3,0,3,0,0,0,6,3,3,3,0,0,3,12,18
1629,67842492,2678400,2678450,1249200,1249250,3,4,0,3,0,0,10,4,3,3,3,0,3,16,26
1630,67842486,2678400,2678450,1248600,1248650,3,3,0,3,0,0,9,4,0,3,3,0,0,10,19
1631,67842494,2678400,2678450,1249400,1249450,3,3,0,0,3,3,12,0,3,0,0,3,3,9,21
1632,67852485,2678500,2678550,1248500,1248550,3,0,0,0,3,0,6,3,0,3,4,3,3,16,22
1633,67852519,2678500,2678550,1251900,1251950,10,3,0,3,4,0,20,9,9,3,3,5,0,29,49
1634,67862489,2678600,2678650,1248900,1248950,3,3,3,3,5,3,20,4,3,6,5,3,3,24,44
1635,67862502,2678600,2678650,1250200,1250250,3,3,3,3,3,0,15,3,3,4,3,0,0,13,28
1636,67872474,2678700,2678750,1247400,1247450,0,0,0,0,0,0,0,0,0,0,0,0,0,0,0
1637,67882477,2678800,2678850,1247700,1247750,3,3,3,0,3,0,12,6,5,3,3,3,0,20,32
1638,67882495,2678800,2678850,1249500,1249550,0,3,0,0,0,0,3,3,3,0,0,0,0,6,9
1639,67882473,2678800,2678850,1247300,1247350,4,3,3,0,0,0,10,3,3,0,3,0,0,9,19
1640,67892490,2678900,2678950,1249000,1249050,3,6,3,9,6,8,35,5,3,6,16,23,20,73,108
1641,67892511,2678900,2678950,1251100,1251150,3,5,3,3,0,0,14,4,5,3,3,3,0,18,32
1642,67892488,2678900,2678950,1248800,1248850,3,0,3,0,0,0,6,3,3,3,0,3,0,12,18
1643,67902507,2679000,2679050,1250700,1250750,3,0,3,3,5,3,17,3,3,6,3,6,3,24,41
1644,67902487,2679000,2679050,1248700,1248750,4,0,3,0,3,0,10,3,3,3,3,0,0,12,22
1645,67902494,2679000,2679050,1249400,1249450,0,4,3,0,0,0,7,3,3,3,3,0,3,15,22
1646,67902476,2679000,2679050,1247600,1247650,3,3,3,3,0,0,12,4,4,3,3,3,3,20,32
1647,67902516,2679000,2679050,1251600,1251650,3,3,0,0,0,0,6,0,3,0,0,3,0,6,12
1648,67902514,2679000,2679050,1251400,1251450,3,8,5,5,0,3,24,5,3,9,8,3,0,28,52
1649,67912472,2679100,2679150,1247200,1247250,4,4,4,3,3,0,18,3,6,4,3,3,3,22,40
1650,67912478,2679100,2679150,1247800,1247850,0,0,0,0,3,0,3,0,3,3,0,0,0,6,9
1651,67922512,2679200,2679250,1251200,1251250,3,3,3,3,3,3,18,5,3,6,3,4,3,24,42
1652,67922481,2679200,2679250,1248100,1248150,0,3,0,3,0,0,6,3,0,3,0,0,0,6,12
1653,67922477,2679200,2679250,1247700,1247750,3,0,3,0,0,0,6,3,3,0,3,0,0,9,15
1654,67932481,2679300,2679350,1248100,1248150,0,3,3,0,0,0,6,3,3,3,0,0,0,9,15
1655,67932467,2679300,2679350,1246700,1246750,3,3,3,0,0,0,9,0,0,3,3,0,0,6,15
1656,67942477,2679400,2679450,1247700,1247750,3,3,4,3,3,3,19,5,3,0,4,3,0,15,34
1657,67942490,2679400,2679450,1249000,1249050,3,0,3,3,0,0,9,3,3,5,3,3,0,17,26
1658,67952484,2679500,2679550,1248400,1248450,0,0,0,0,0,0,0,0,0,0,0,0,0,0,0
1659,67952470,2679500,2679550,1247000,1247050,3,0,0,0,0,0,3,0,3,3,0,0,0,6,9
1660,67952529,2679500,2679550,1252900,1252950,0,3,0,3,3,0,9,0,0,3,3,3,0,9,18
1661,67962506,2679600,2679650,1250600,1250650,3,3,4,3,0,3,16,3,5,3,3,3,3,20,36
1662,67962501,2679600,2679650,1250100,1250150,3,3,0,0,0,0,6,3,3,3,0,3,0,12,18
1663,67962475,2679600,2679650,1247500,1247550,0,0,0,0,0,0,0,0,0,0,3,0,0,3,3
1664,67962488,2679600,2679650,1248800,1248850,0,3,0,0,3,0,6,3,3,3,3,3,0,15,21
1665,67972467,2679700,2679750,1246700,1246750,3,3,3,3,0,0,12,3,3,3,3,0,0,12,24
1666,67972506,2679700,2679750,1250600,1250650,3,0,3,0,0,0,6,3,0,3,0,3,0,9,15
1667,67982507,2679800,2679850,1250700,1250750,3,0,3,0,3,3,12,3,3,3,4,3,3,19,31
1668,67982506,2679800,2679850,1250600,1250650,3,3,0,3,0,3,12,0,0,3,3,0,0,6,18
1669,67982470,2679800,2679850,1247000,1247050,8,6,3,3,3,3,26,6,7,4,3,4,5,29,55
1670,67982500,2679800,2679850,1250000,1250050,3,3,3,0,0,0,9,3,0,3,0,0,0,6,15
1671,67982477,2679800,2679850,1247700,1247750,0,3,3,3,3,0,12,3,3,3,0,3,3,15,27
1672,67982462,2679800,2679850,1246200,1246250,0,0,0,0,0,0,0,0,0,0,0,0,0,0,0
1673,68292530,2682900,2682950,1253000,1253050,3,3,3,3,3,0,15,0,3,0,3,3,0,9,24
1674,68292479,2682900,2682950,1247900,1247950,0,0,0,0,0,0,0,0,0,0,0,0,0,0,0
1675,68302538,2683000,2683050,1253800,1253850,0,3,3,3,3,0,12,3,3,4,3,3,0,16,28
1676,68302520,2683000,2683050,1252000,1252050,3,4,3,5,8,17,40,4,3,3,19,28,28,85,125
1677,68302475,2683000,2683050,1247500,1247550,0,0,0,0,0,0,0,0,0,0,0,0,0,0,0
1678,68302487,2683000,2683050,1248700,1248750,3,3,0,0,3,0,9,3,0,0,0,0,0,3,12
1679,68302478,2683000,2683050,1247800,1247850,0,0,0,0,0,0,0,0,0,0,0,0,0,0,0
1680,68312474,2683100,2683150,1247400,1247450,0,3,3,3,0,3,12,3,4,5,3,3,0,18,30
1681,68312504,2683100,2683150,1250400,1250450,3,5,3,3,3,3,20,4,5,3,0,3,3,18,38
1682,68312431,2683100,2683150,1243100,1243150,3,3,0,0,0,0,6,3,3,0,3,3,0,12,18
1683,68322524,2683200,2683250,1252400,1252450,0,3,3,3,3,0,12,3,3,0,0,3,0,9,21
1684,68322499,2683200,2683250,1249900,1249950,3,5,3,0,3,0,14,6,4,3,3,3,3,22,36
1685,68322473,2683200,2683250,1247300,1247350,5,6,4,0,0,0,15,3,0,5,3,3,0,14,29
1686,68322503,2683200,2683250,1250300,1250350,3,3,3,0,3,0,12,3,3,0,3,3,3,15,27
1687,68332513,2683300,2683350,1251300,1251350,3,6,4,3,0,0,16,3,8,6,3,3,0,23,39
1688,68332534,2683300,2683350,1253400,1253450,3,3,0,3,3,3,15,3,0,3,3,3,0,12,27
1689,68332475,2683300,2683350,1247500,1247550,0,3,5,3,0,3,14,4,6,0,3,0,0,13,27
1690,68332526,2683300,2683350,1252600,1252650,0,3,3,0,0,0,6,0,3,3,0,3,0,9,15
1691,68332476,2683300,2683350,1247600,1247650,0,0,3,0,0,0,3,0,0,0,3,0,0,3,6
1692,68342486,2683400,2683450,1248600,1248650,3,0,3,3,0,0,9,4,3,0,3,0,0,10,19
1693,68342537,2683400,2683450,1253700,1253750,3,3,0,3,0,0,9,0,3,0,3,3,0,9,18
1694,68342509,2683400,2683450,1250900,1250950,4,3,5,3,3,0,18,4,3,3,3,3,3,19,37
1695,68342500,2683400,2683450,1250000,1250050,3,3,3,0,3,0,12,0,0,3,0,0,0,3,15
1696,68342505,2683400,2683450,1250500,1250550,3,3,3,0,0,0,9,3,3,3,0,0,0,9,18
1697,68342507,2683400,2683450,1250700,1250750,3,3,0,0,0,0,6,4,3,3,3,3,3,19,25
1698,68342472,2683400,2683450,1247200,1247250,3,3,3,3,0,3,15,3,6,3,3,3,0,18,33
1699,68342483,2683400,2683450,1248300,1248350,0,0,0,0,0,0,0,0,3,0,0,3,0,6,6
1700,68342470,2683400,2683450,1247000,1247050,0,3,0,3,0,0,6,3,0,0,0,0,0,3,9
1701,68352498,2683500,2683550,1249800,1249850,3,3,3,0,0,0,9,3,3,0,0,0,0,6,15
1702,68352514,2683500,2683550,1251400,1251450,0,3,0,0,3,0,6,3,3,0,3,0,0,9,15
1703,68362473,2683600,2683650,1247300,1247350,3,3,0,0,0,0,6,3,3,0,3,0,0,9,15
1704,68372487,2683700,2683750,1248700,1248750,0,3,0,0,0,0,3,3,3,3,3,0,0,12,15
1705,68372491,2683700,2683750,1249100,1249150,3,5,4,0,0,0,12,3,6,3,3,0,0,15,27
1706,68372509,2683700,2683750,1250900,1250950,3,3,0,0,0,0,6,0,0,3,0,0,0,3,9
1707,68372517,2683700,2683750,1251700,1251750,3,3,0,3,0,0,9,0,3,0,3,0,0,6,15
1708,68382484,2683800,2683850,1248400,1248450,3,3,3,3,0,0,12,4,4,0,0,0,0,8,20
1709,68382506,2683800,2683850,1250600,1250650,3,3,3,3,0,0,12,3,0,3,3,3,3,15,27
1710,68382492,2683800,2683850,1249200,1249250,3,3,0,0,3,3,12,0,3,0,3,0,3,9,21
1711,68382533,2683800,2683850,1253300,1253350,0,0,0,3,0,0,3,3,0,0,3,0,0,6,9
1712,68392470,2683900,2683950,1247000,1247050,3,4,3,3,0,0,13,3,3,3,3,3,0,15,28
1713,68392489,2683900,2683950,1248900,1248950,3,3,3,0,3,3,15,3,3,3,3,3,3,18,33
1714,68402472,2684000,2684050,1247200,1247250,3,3,6,3,3,0,18,3,3,3,3,0,0,12,30
1715,68402507,2684000,2684050,1250700,1250750,0,0,3,3,0,0,6,0,3,3,3,0,0,9,15
1716,68402496,2684000,2684050,1249600,1249650,3,0,0,0,0,0,3,3,0,0,0,0,0,3,6
1717,68402482,2684000,2684050,1248200,1248250,0,3,4,0,3,3,13,3,3,5,3,3,0,17,30
1718,68402529,2684000,2684050,1252900,1252950,3,3,0,3,0,0,9,3,3,3,0,0,3,12,21
1719,68412534,2684100,2684150,1253400,1253450,3,3,3,3,3,3,18,4,5,3,3,3,3,21,39
1720,68412507,2684100,2684150,1250700,1250750,0,3,3,3,0,0,9,3,3,3,3,3,0,15,24
1721,68412509,2684100,2684150,1250900,1250950,0,4,3,3,0,0,10,3,3,3,0,3,0,12,22
1722,68422484,2684200,2684250,1248400,1248450,7,5,6,3,0,0,21,12,3,4,6,3,3,31,52
1723,68422474,2684200,2684250,1247400,1247450,3,3,3,0,0,0,9,3,4,3,3,0,0,13,22
1724,68422473,2684200,2684250,1247300,1247350,3,3,0,3,0,0,9,3,0,3,0,0,0,6,15
1725,68422531,2684200,2684250,1253100,1253150,0,0,0,0,0,0,0,0,0,0,0,0,0,0,0
1726,68432485,2684300,2684350,1248500,1248550,3,0,3,0,0,0,6,3,3,3,0,3,3,15,21
1727,68432473,2684300,2684350,1247300,1247350,3,0,0,0,0,3,6,3,3,0,3,0,0,9,15
1728,68432454,2684300,2684350,1245400,1245450,5,3,4,3,0,0,15,7,5,3,3,3,0,21,36
1729,68432507,2684300,2684350,1250700,1250750,0,0,0,0,0,0,0,3,0,0,3,0,0,6,6
1730,68432462,2684300,2684350,1246200,1246250,3,0,3,3,0,3,12,0,3,0,3,0,0,6,18
1731,68432478,2684300,2684350,1247800,1247850,3,0,3,3,0,0,9,0,3,3,0,3,3,12,21
1732,68442513,2684400,2684450,1251300,1251350,0,3,0,3,3,0,9,3,4,3,0,0,0,10,19
1733,68442466,2684400,2684450,1246600,1246650,3,4,0,3,0,0,10,7,7,3,3,3,3,26,36
1734,68442484,2684400,2684450,1248400,1248450,3,3,3,3,3,0,15,0,3,0,3,0,0,6,21
1735,68442477,2684400,2684450,1247700,1247750,3,3,3,3,0,3,15,3,3,3,3,0,4,16,31
1736,68442511,2684400,2684450,1251100,1251150,3,3,3,0,0,0,9,0,3,3,3,0,0,9,18
1737,68442470,2684400,2684450,1247000,1247050,3,0,3,3,0,3,12,3,3,3,3,3,3,18,30
1738,68452456,2684500,2684550,1245600,1245650,3,4,3,0,3,0,13,4,4,3,4,3,3,21,34
1739,68452454,2684500,2684550,1245400,1245450,3,3,3,3,0,0,12,3,3,3,3,3,0,15,27
1740,68452472,2684500,2684550,1247200,1247250,3,5,4,3,3,0,18,8,4,6,3,3,0,24,42
1741,68452479,2684500,2684550,1247900,1247950,4,3,3,3,3,0,16,5,3,3,0,3,3,17,33
1742,68452461,2684500,2684550,1246100,1246150,0,0,0,0,0,0,0,0,0,0,0,0,0,0,0
1743,68462512,2684600,2684650,1251200,1251250,3,3,3,3,0,0,12,3,3,5,3,0,0,14,26
1744,68462466,2684600,2684650,1246600,1246650,3,3,0,3,0,0,9,3,3,3,0,0,3,12,21
1745,68462518,2684600,2684650,1251800,1251850,4,5,3,3,3,0,18,7,6,4,3,4,0,24,42
1746,68462462,2684600,2684650,1246200,1246250,3,0,3,0,0,0,6,0,0,0,3,0,3,6,12
1747,68462517,2684600,2684650,1251700,1251750,3,3,0,3,0,0,9,3,3,0,3,3,3,15,24
1748,68472485,2684700,2684750,1248500,1248550,3,3,4,0,3,0,13,3,0,3,3,0,0,9,22
1749,68472509,2684700,2684750,1250900,1250950,7,5,0,3,3,0,18,3,4,5,3,3,0,18,36
1750,68472462,2684700,2684750,1246200,1246250,3,3,3,0,3,0,12,4,3,3,3,3,0,16,28
1751,68472465,2684700,2684750,1246500,1246550,3,3,0,3,3,3,15,0,3,4,3,3,3,16,31
1752,68472508,2684700,2684750,1250800,1250850,0,0,0,0,0,0,0,3,0,0,0,0,0,3,3
1753,68472453,2684700,2684750,1245300,1245350,3,3,3,0,3,0,12,4,3,3,3,3,0,16,28
1754,68482467,2684800,2684850,1246700,1246750,3,3,4,0,3,0,13,6,0,6,3,3,0,18,31
1755,68482456,2684800,2684850,1245600,1245650,3,3,0,0,0,0,6,0,3,3,0,0,3,9,15
1756,68482475,2684800,2684850,1247500,1247550,0,0,0,3,0,0,3,3,0,3,3,3,3,15,18
1757,68492512,2684900,2684950,1251200,1251250,3,3,3,0,3,3,15,4,6,0,3,3,3,19,34
1758,68492469,2684900,2684950,1246900,1246950,3,3,3,0,0,0,9,3,3,3,0,3,0,12,21
1759,68492511,2684900,2684950,1251100,1251150,3,3,3,0,0,0,9,0,3,3,0,0,0,6,15
1760,68502472,2685000,2685050,1247200,1247250,3,3,0,3,0,0,9,3,0,3,3,3,3,15,24
1761,68502484,2685000,2685050,1248400,1248450,0,0,0,0,3,0,3,0,0,0,0,3,0,3,6
1762,68502449,2685000,2685050,1244900,1244950,3,3,4,0,0,0,10,6,3,3,0,3,0,15,25
1763,68512469,2685100,2685150,1246900,1246950,0,0,3,0,0,0,3,0,3,0,0,0,0,3,6
1764,68522446,2685200,2685250,1244600,1244650,3,3,3,3,0,0,12,3,3,3,3,0,3,15,27
1765,68522466,2685200,2685250,1246600,1246650,0,3,3,3,0,3,12,5,3,3,3,0,3,17,29
1766,68522465,2685200,2685250,1246500,1246550,3,0,3,0,0,0,6,3,3,4,3,0,3,16,22
1767,68522452,2685200,2685250,1245200,1245250,0,3,0,0,0,0,3,0,3,0,3,0,0,6,9
1768,68532459,2685300,2685350,1245900,1245950,0,0,0,3,0,0,3,0,3,3,3,0,0,9,12
1769,68532479,2685300,2685350,1247900,1247950,3,0,0,0,0,0,3,3,3,0,0,0,0,6,9
1770,68542515,2685400,2685450,1251500,1251550,3,0,0,0,0,0,3,0,3,3,0,3,3,12,15
1771,68552462,2685500,2685550,1246200,1246250,3,3,0,3,0,0,9,3,3,0,3,0,0,9,18
1772,68552513,2685500,2685550,1251300,1251350,0,0,0,0,0,0,0,0,0,0,0,0,0,0,0
1773,68552484,2685500,2685550,1248400,1248450,0,0,0,0,3,0,3,0,0,0,0,0,0,0,3
1774,68562457,2685600,2685650,1245700,1245750,0,3,0,3,0,0,6,0,0,0,3,0,0,3,9
1775,68562510,2685600,2685650,1251000,1251050,3,4,3,3,3,0,16,5,8,3,5,3,0,24,40
1776,68572460,2685700,2685750,1246000,1246050,3,3,3,0,3,3,15,3,3,3,4,6,13,32,47
1777,68572512,2685700,2685750,1251200,1251250,3,3,3,0,0,0,9,3,0,7,4,3,3,20,29
1778,68572454,2685700,2685750,1245400,1245450,0,0,0,3,0,0,3,0,0,0,0,0,0,0,3
1779,68582513,2685800,2685850,1251300,1251350,3,3,0,0,0,3,9,3,0,3,3,3,3,15,24
1780,68582512,2685800,2685850,1251200,1251250,5,3,3,0,0,0,11,6,7,3,0,3,3,22,33
1781,68582455,2685800,2685850,1245500,1245550,3,0,0,3,0,3,9,3,0,3,3,0,0,9,18
1782,68602460,2686000,2686050,1246000,1246050,0,0,0,3,0,0,3,0,0,0,0,0,0,0,3
1783,68602508,2686000,2686050,1250800,1250850,7,3,5,3,3,0,21,6,3,4,3,3,0,19,40
1784,68602452,2686000,2686050,1245200,1245250,0,0,0,0,0,0,0,0,0,0,0,0,0,0,0
1785,68612462,2686100,2686150,1246200,1246250,3,3,0,3,0,3,12,3,3,4,0,3,0,13,25
1786,68612508,2686100,2686150,1250800,1250850,3,3,0,0,3,0,9,4,3,3,3,0,0,13,22
1787,68612510,2686100,2686150,1251000,1251050,4,3,3,0,3,3,16,7,4,3,4,3,3,24,40
1788,68612451,2686100,2686150,1245100,1245150,0,0,0,0,0,0,0,0,0,0,0,0,0,0,0
1789,68622515,2686200,2686250,1251500,1251550,3,3,0,3,0,0,9,3,3,0,3,0,0,9,18
1790,68632460,2686300,2686350,1246000,1246050,3,0,0,0,3,0,6,0,3,0,0,3,3,9,15
1791,68642461,2686400,2686450,1246100,1246150,3,3,0,4,0,0,10,4,5,3,0,3,3,18,28
1792,68642456,2686400,2686450,1245600,1245650,0,3,3,0,0,0,6,3,3,0,3,3,0,12,18
1793,68652486,2686500,2686550,1248600,1248650,0,3,0,0,0,0,3,0,0,0,0,0,0,0,3
1794,68662486,2686600,2686650,1248600,1248650,3,3,0,0,0,0,6,3,0,0,0,0,0,3,9
1795,68672505,2686700,2686750,1250500,1250550,3,5,3,0,3,3,17,5,4,4,0,5,3,21,38
1796,68682508,2686800,2686850,1250800,1250850,4,3,5,4,3,3,22,4,7,4,5,3,3,26,48
1797,67792489,2677900,2677950,1248900,1248950,0,0,0,0,3,0,3,3,3,0,3,0,0,9,12
1798,67812489,2678100,2678150,1248900,1248950,3,3,0,3,0,0,9,3,3,0,3,3,0,12,21
1799,67832520,2678300,2678350,1252000,1252050,3,5,3,3,0,0,14,6,3,4,3,4,3,23,37
1800,67832495,2678300,2678350,1249500,1249550,3,3,3,3,0,0,12,4,0,5,3,3,0,15,27
1801,67842488,2678400,2678450,1248800,1248850,8,0,3,0,3,0,14,3,3,3,3,0,0,12,26
1802,67852510,2678500,2678550,1251000,1251050,3,3,0,0,0,0,6,3,3,3,0,0,0,9,15
1803,67862494,2678600,2678650,1249400,1249450,8,3,4,4,3,0,22,8,8,7,5,3,3,34,56
1804,67862482,2678600,2678650,1248200,1248250,3,3,6,3,3,3,21,3,3,4,3,4,3,20,41
1805,67862491,2678600,2678650,1249100,1249150,0,0,3,3,0,0,6,0,3,3,3,0,0,9,15
1806,67872494,2678700,2678750,1249400,1249450,3,3,3,0,0,3,12,5,3,3,0,3,0,14,26
1807,67882509,2678800,2678850,1250900,1250950,0,0,0,0,0,0,0,0,0,3,0,0,0,3,3
1808,67892500,2678900,2678950,1250000,1250050,5,5,7,4,0,3,24,8,3,6,7,3,3,30,54
1809,67892485,2678900,2678950,1248500,1248550,3,3,3,3,0,0,12,0,3,3,0,0,0,6,18
1810,67892508,2678900,2678950,1250800,1250850,0,0,0,0,0,0,0,3,0,0,0,0,0,3,3
1811,67902473,2679000,2679050,1247300,1247350,3,3,3,3,0,0,12,3,3,3,3,0,0,12,24
1812,67902492,2679000,2679050,1249200,1249250,5,3,0,3,0,0,11,5,5,3,0,3,0,16,27
1813,67902508,2679000,2679050,1250800,1250850,3,3,0,0,0,0,6,3,6,3,0,0,3,15,21
1814,67902515,2679000,2679050,1251500,1251550,3,3,0,3,0,3,12,4,3,3,3,3,3,19,31
1815,67902499,2679000,2679050,1249900,1249950,3,0,0,3,0,0,6,3,3,0,0,0,0,6,12
1816,67902513,2679000,2679050,1251300,1251350,3,3,3,3,0,0,12,3,3,4,3,3,0,16,28
1817,67902491,2679000,2679050,1249100,1249150,5,3,5,3,3,0,19,3,3,4,3,0,3,16,35
1818,67912485,2679100,2679150,1248500,1248550,3,0,3,0,3,0,9,0,3,3,0,3,0,9,18
1819,67922493,2679200,2679250,1249300,1249350,3,4,3,3,0,0,13,3,3,3,3,3,0,15,28
1820,67922492,2679200,2679250,1249200,1249250,3,3,6,3,0,0,15,5,4,3,0,3,0,15,30
1821,67922511,2679200,2679250,1251100,1251150,3,3,3,3,0,0,12,3,3,3,3,3,3,18,30
1822,67932499,2679300,2679350,1249900,1249950,0,3,0,3,4,8,18,3,3,3,5,26,23,63,81
1823,67942489,2679400,2679450,1248900,1248950,0,3,0,0,0,0,3,0,0,0,3,0,0,3,6
1824,67942478,2679400,2679450,1247800,1247850,3,3,3,3,0,0,12,3,3,3,3,3,0,15,27
1825,67942483,2679400,2679450,1248300,1248350,3,3,3,0,0,0,9,3,3,0,0,0,0,6,15
1826,67942504,2679400,2679450,1250400,1250450,8,3,4,3,3,0,21,7,3,3,0,0,0,13,34
1827,67952475,2679500,2679550,1247500,1247550,3,7,4,3,3,3,23,5,7,6,4,5,7,34,57
1828,67952473,2679500,2679550,1247300,1247350,0,3,3,3,3,0,12,5,6,3,4,3,0,21,33
1829,67972529,2679700,2679750,1252900,1252950,3,3,3,0,0,0,9,3,3,3,3,0,3,15,24
1830,67972488,2679700,2679750,1248800,1248850,3,0,0,3,0,0,6,3,0,0,0,0,0,3,9
1831,67982509,2679800,2679850,1250900,1250950,0,3,0,3,3,0,9,3,3,4,3,3,0,16,25
1832,67982508,2679800,2679850,1250800,1250850,0,3,0,0,0,0,3,0,3,3,0,0,0,6,9
1833,67982464,2679800,2679850,1246400,1246450,3,0,0,0,0,0,3,3,3,3,3,0,0,12,15
1834,67992525,2679900,2679950,1252500,1252550,0,0,0,0,0,0,0,3,0,0,0,0,0,3,3
1835,67992503,2679900,2679950,1250300,1250350,3,0,3,3,0,0,9,3,3,3,0,0,0,9,18
1836,67992483,2679900,2679950,1248300,1248350,3,0,0,0,3,0,6,0,3,0,0,3,3,9,15
1837,67992510,2679900,2679950,1251000,1251050,0,3,4,3,3,3,16,3,4,4,7,0,3,21,37
1838,68002531,2680000,2680050,1253100,1253150,7,8,3,3,3,0,24,9,7,3,0,3,0,22,46
1839,68002507,2680000,2680050,1250700,1250750,0,0,0,0,0,0,0,0,3,3,0,0,0,6,6
1840,68012475,2680100,2680150,1247500,1247550,3,3,3,4,6,0,19,3,4,4,7,3,3,24,43
1841,68012484,2680100,2680150,1248400,1248450,3,0,3,3,3,0,12,0,3,0,3,0,0,6,18
1842,68012531,2680100,2680150,1253100,1253150,4,3,3,0,0,0,10,3,3,3,0,0,0,9,19
1843,68012528,2680100,2680150,1252800,1252850,3,3,0,0,0,0,6,3,3,0,0,0,0,6,12
1844,68012482,2680100,2680150,1248200,1248250,3,3,0,0,3,0,9,3,3,0,3,0,0,9,18
1845,68012530,2680100,2680150,1253000,1253050,5,3,0,3,0,0,11,3,4,0,3,0,0,10,21
1846,68022503,2680200,2680250,1250300,1250350,0,0,3,0,0,3,6,0,0,0,3,0,0,3,9
1847,68022487,2680200,2680250,1248700,1248750,3,3,4,3,0,0,13,3,3,6,3,3,3,21,34
1848,68022476,2680200,2680250,1247600,1247650,3,3,3,3,0,0,12,0,3,0,0,0,0,3,15
1849,68032463,2680300,2680350,1246300,1246350,3,3,3,0,0,0,9,3,3,3,3,0,0,12,21
1850,68032529,2680300,2680350,1252900,1252950,0,3,0,3,0,0,6,3,0,3,3,0,0,9,15
1851,68042462,2680400,2680450,1246200,1246250,3,3,3,0,0,0,9,3,3,4,3,3,3,19,28
1852,68042454,2680400,2680450,1245400,1245450,0,0,0,0,0,0,0,0,0,0,0,0,0,0,0
1853,68042484,2680400,2680450,1248400,1248450,0,0,0,0,3,0,3,0,0,0,3,0,0,3,6
1854,68052481,2680500,2680550,1248100,1248150,6,7,3,3,3,3,25,7,6,3,3,0,0,19,44
1855,68052470,2680500,2680550,1247000,1247050,3,0,3,0,0,0,6,3,3,3,3,3,3,18,24
1856,68052474,2680500,2680550,1247400,1247450,3,3,3,3,3,0,15,3,3,7,3,4,3,23,38
1857,68052479,2680500,2680550,1247900,1247950,3,0,0,0,0,0,3,0,0,0,0,0,0,0,3
1858,68062505,2680600,2680650,1250500,1250550,3,3,4,3,3,0,16,3,3,4,3,0,3,16,32
1859,68062483,2680600,2680650,1248300,1248350,4,0,0,0,0,0,4,3,0,0,0,0,0,3,7
1860,68062482,2680600,2680650,1248200,1248250,0,0,3,3,3,0,9,3,3,3,0,0,0,9,18
1861,68072463,2680700,2680750,1246300,1246350,0,3,0,0,0,0,3,0,3,0,0,0,0,3,6
1862,68072481,2680700,2680750,1248100,1248150,4,3,3,3,0,3,16,5,3,3,3,3,3,20,36
1863,68072454,2680700,2680750,1245400,1245450,0,0,0,3,0,0,3,0,3,0,3,0,0,6,9
1864,68082472,2680800,2680850,1247200,1247250,3,3,3,3,3,0,15,3,3,3,0,3,3,15,30
1865,68082457,2680800,2680850,1245700,1245750,3,4,3,0,0,0,10,3,3,3,0,0,0,9,19
1866,68082473,2680800,2680850,1247300,1247350,3,3,0,3,0,0,9,0,3,3,0,0,0,6,15
1867,68092530,2680900,2680950,1253000,1253050,7,11,8,7,4,3,40,10,11,14,5,6,3,49,89
1868,68092487,2680900,2680950,1248700,1248750,3,3,3,0,0,0,9,3,3,0,0,0,0,6,15
1869,68102528,2681000,2681050,1252800,1252850,5,8,3,3,0,3,22,8,8,5,3,4,3,31,53
1870,68102522,2681000,2681050,1252200,1252250,3,0,0,0,0,0,3,0,0,0,0,0,0,0,3
1871,68102518,2681000,2681050,1251800,1251850,3,4,3,3,0,0,13,4,3,3,3,3,3,19,32
1872,68102483,2681000,2681050,1248300,1248350,3,3,0,0,0,0,6,3,3,0,0,0,3,9,15
1873,68112477,2681100,2681150,1247700,1247750,3,3,3,0,0,0,9,3,4,3,0,0,3,13,22
1874,68112480,2681100,2681150,1248000,1248050,6,8,3,3,3,0,23,5,6,3,3,3,3,23,46
1875,68112418,2681100,2681150,1241800,1241850,0,0,0,0,0,0,0,0,0,0,0,0,0,0,0
1876,68112425,2681100,2681150,1242500,1242550,0,0,0,0,0,0,0,0,0,0,0,0,0,0,0
1877,68122428,2681200,2681250,1242800,1242850,0,3,3,0,3,0,9,3,0,3,3,0,0,9,18
1878,68122474,2681200,2681250,1247400,1247450,5,3,3,0,0,0,11,6,7,3,3,3,0,22,33
1879,68122480,2681200,2681250,1248000,1248050,3,3,0,3,0,0,9,4,3,3,3,0,0,13,22
1880,68122523,2681200,2681250,1252300,1252350,3,0,3,0,0,0,6,0,3,3,3,0,0,9,15
1881,68122517,2681200,2681250,1251700,1251750,0,0,3,0,0,0,3,3,0,3,3,0,3,12,15
1882,68122489,2681200,2681250,1248900,1248950,0,0,0,0,0,0,0,3,0,0,0,0,0,3,3
1883,68122419,2681200,2681250,1241900,1241950,3,3,0,0,3,3,12,0,3,3,0,3,3,12,24
1884,68132476,2681300,2681350,1247600,1247650,3,5,3,3,0,0,14,3,3,6,3,0,0,15,29
1885,68132425,2681300,2681350,1242500,1242550,3,3,4,3,4,0,17,4,4,7,6,3,3,27,44
1886,68132460,2681300,2681350,1246000,1246050,3,0,0,0,0,0,3,3,0,0,3,0,0,6,9
1887,68142481,2681400,2681450,1248100,1248150,4,5,3,0,0,3,15,3,3,5,3,3,3,20,35
1888,68142426,2681400,2681450,1242600,1242650,3,3,0,0,0,0,6,0,3,0,0,0,3,6,12
1889,68152424,2681500,2681550,1242400,1242450,3,5,3,3,0,3,17,4,3,6,3,0,0,16,33
1890,68152466,2681500,2681550,1246600,1246650,3,3,3,3,0,3,15,3,3,3,3,0,0,12,27
1891,68162458,2681600,2681650,1245800,1245850,3,0,0,0,0,0,3,3,3,0,3,0,0,9,12
1892,68162472,2681600,2681650,1247200,1247250,9,5,12,5,5,6,42,3,3,8,9,11,16,50,92
1893,68162431,2681600,2681650,1243100,1243150,0,3,3,0,0,3,9,3,0,3,0,0,0,6,15
1894,68162424,2681600,2681650,1242400,1242450,3,0,0,3,0,0,6,3,4,0,3,3,0,13,19
1895,68162430,2681600,2681650,1243000,1243050,3,0,0,0,0,0,3,0,0,0,0,0,0,0,3
1896,68162433,2681600,2681650,1243300,1243350,3,0,0,3,3,0,9,4,3,4,6,3,3,23,32
1897,68172467,2681700,2681750,1246700,1246750,4,3,3,3,0,0,13,7,3,3,3,3,0,19,32
1898,68182438,2681800,2681850,1243800,1243850,0,0,0,0,0,0,0,0,0,3,0,0,0,3,3
1899,68182463,2681800,2681850,1246300,1246350,3,0,0,3,0,0,6,0,0,0,0,0,0,0,6
1900,68182519,2681800,2681850,1251900,1251950,0,3,0,3,0,0,6,3,3,3,3,3,3,18,24
1901,68182459,2681800,2681850,1245900,1245950,3,3,0,3,0,0,9,3,3,3,3,0,0,12,21
1902,68182458,2681800,2681850,1245800,1245850,0,0,0,0,0,0,0,0,0,0,0,0,0,0,0
1903,68182487,2681800,2681850,1248700,1248750,3,0,0,0,0,0,3,3,3,0,0,0,0,6,9
1904,68192501,2681900,2681950,1250100,1250150,3,0,0,0,3,0,6,3,3,0,3,0,0,9,15
1905,68192442,2681900,2681950,1244200,1244250,4,4,3,4,3,3,21,0,0,0,0,0,0,0,21
1906,68202481,2682000,2682050,1248100,1248150,3,3,0,3,0,0,9,3,0,3,3,0,0,9,18
1907,68202441,2682000,2682050,1244100,1244150,0,3,0,3,0,0,6,0,3,3,0,3,0,9,15
1908,68202459,2682000,2682050,1245900,1245950,3,3,3,3,0,0,12,3,3,3,4,3,3,19,31
1909,68202469,2682000,2682050,1246900,1246950,0,0,0,0,0,0,0,0,0,0,0,0,0,0,0
1910,68202495,2682000,2682050,1249500,1249550,3,3,3,3,0,3,15,3,3,3,0,3,3,15,30
1911,68202438,2682000,2682050,1243800,1243850,0,3,3,0,0,0,6,3,3,3,3,0,0,12,18
1912,68212458,2682100,2682150,1245800,1245850,3,3,3,3,3,3,18,4,7,3,3,3,3,23,41
1913,68212502,2682100,2682150,1250200,1250250,5,3,0,0,0,0,8,3,3,0,0,0,0,6,14
1914,68212514,2682100,2682150,1251400,1251450,3,3,3,3,0,0,12,4,3,3,3,3,3,19,31
1915,68212486,2682100,2682150,1248600,1248650,10,4,0,0,3,0,17,8,3,3,3,0,0,17,34
1916,68222482,2682200,2682250,1248200,1248250,5,3,3,0,0,0,11,3,0,0,3,0,0,6,17
1917,68222498,2682200,2682250,1249800,1249850,3,3,5,0,0,0,11,5,3,3,0,0,0,11,22
1918,68222522,2682200,2682250,1252200,1252250,3,0,3,3,0,3,12,3,0,3,5,3,3,17,29
1919,68222433,2682200,2682250,1243300,1243350,0,3,3,3,3,0,12,3,5,3,3,3,0,17,29
1920,68232517,2682300,2682350,1251700,1251750,3,3,3,0,3,3,15,3,3,3,0,4,0,13,28
1921,68232473,2682300,2682350,1247300,1247350,5,3,3,4,4,4,23,3,6,3,7,16,20,55,78
1922,68232496,2682300,2682350,1249600,1249650,4,3,3,0,0,3,13,4,3,0,0,0,3,10,23
1923,68232519,2682300,2682350,1251900,1251950,0,0,3,3,0,0,6,3,0,3,3,0,0,9,15
1924,68232439,2682300,2682350,1243900,1243950,3,3,3,3,3,0,15,3,3,4,3,0,3,16,31
1925,68232454,2682300,2682350,1245400,1245450,0,0,3,3,3,0,9,3,0,0,3,0,0,6,15
1926,68232490,2682300,2682350,1249000,1249050,9,6,6,5,3,3,32,3,8,9,3,4,0,27,59
1927,68232423,2682300,2682350,1242300,1242350,0,0,0,0,0,0,0,0,0,0,0,0,0,0,0
1928,68242487,2682400,2682450,1248700,1248750,3,3,3,3,0,0,12,3,3,3,3,0,3,15,27
1929,68242444,2682400,2682450,1244400,1244450,3,3,3,3,3,0,15,3,3,3,3,3,3,18,33
1930,68242452,2682400,2682450,1245200,1245250,3,3,3,0,0,3,12,3,3,3,3,3,0,15,27
1931,68242497,2682400,2682450,1249700,1249750,3,6,3,3,0,0,15,3,3,3,3,0,0,12,27
1932,68242502,2682400,2682450,1250200,1250250,0,3,0,0,0,0,3,0,0,0,3,0,0,3,6
1933,68242446,2682400,2682450,1244600,1244650,3,3,3,0,3,0,12,3,3,0,3,3,3,15,27
1934,68242511,2682400,2682450,1251100,1251150,0,0,0,0,0,0,0,0,0,0,0,0,0,0,0
1935,68242428,2682400,2682450,1242800,1242850,0,0,0,0,0,0,0,0,0,0,0,3,0,3,3
1936,68252517,2682500,2682550,1251700,1251750,0,0,0,3,0,0,3,3,0,3,0,0,0,6,9
1937,68252435,2682500,2682550,1243500,1243550,3,3,0,0,0,0,6,0,3,3,0,0,0,6,12
1938,68252506,2682500,2682550,1250600,1250650,3,4,3,0,0,0,10,4,3,3,0,0,0,10,20
1939,68262461,2682600,2682650,1246100,1246150,3,3,0,3,0,3,12,3,0,3,0,0,0,6,18
1940,68262438,2682600,2682650,1243800,1243850,3,3,4,0,3,3,16,0,4,4,0,3,3,14,30
1941,68272516,2682700,2682750,1251600,1251650,5,3,3,3,3,0,17,5,5,3,3,4,0,20,37
1942,68272524,2682700,2682750,1252400,1252450,3,3,3,0,0,0,9,3,3,3,0,0,0,9,18
1943,68272526,2682700,2682750,1252600,1252650,3,3,3,3,0,0,12,3,3,3,3,0,0,12,24
1944,68282432,2682800,2682850,1243200,1243250,3,0,5,3,3,0,14,0,3,3,3,9,10,28,42
1945,68282495,2682800,2682850,1249500,1249550,0,0,0,3,0,3,6,0,0,0,3,0,0,3,9
1946,68282502,2682800,2682850,1250200,1250250,3,3,3,0,0,0,9,3,3,3,3,0,0,12,21
1947,68282429,2682800,2682850,1242900,1242950,3,3,5,3,3,3,20,3,4,0,3,3,0,13,33
1948,68282512,2682800,2682850,1251200,1251250,3,3,0,3,0,0,9,3,3,3,3,3,0,15,24
1949,68282427,2682800,2682850,1242700,1242750,0,3,3,0,0,0,6,3,0,0,3,3,0,9,15
1950,68282527,2682800,2682850,1252700,1252750,3,3,0,3,3,0,12,5,3,4,3,3,0,18,30
1951,68282490,2682800,2682850,1249000,1249050,0,0,3,0,0,0,3,3,3,3,3,0,0,12,15
1952,68282471,2682800,2682850,1247100,1247150,3,0,0,0,0,0,3,0,0,0,0,0,0,0,3
1953,68292516,2682900,2682950,1251600,1251650,3,0,0,0,0,0,3,3,3,3,3,0,0,12,15
1954,68292485,2682900,2682950,1248500,1248550,3,0,3,0,0,0,6,3,3,0,0,0,0,6,12
1955,68302513,2683000,2683050,1251300,1251350,3,0,3,0,0,3,9,0,4,0,0,3,0,7,16
1956,68302532,2683000,2683050,1253200,1253250,3,3,3,3,3,0,15,4,6,0,3,3,3,19,34
1957,68302505,2683000,2683050,1250500,1250550,3,3,3,0,0,0,9,4,3,3,0,0,0,10,19
1958,68302467,2683000,2683050,1246700,1246750,3,0,0,0,0,0,3,0,0,0,0,0,0,0,3
1959,68302473,2683000,2683050,1247300,1247350,0,0,0,0,0,0,0,0,0,0,0,0,0,0,0
1960,68312537,2683100,2683150,1253700,1253750,3,4,6,3,4,3,23,4,3,10,7,4,3,31,54
1961,68312514,2683100,2683150,1251400,1251450,3,3,3,3,3,3,18,3,3,3,3,3,3,18,36
1962,68312520,2683100,2683150,1252000,1252050,0,0,0,0,0,0,0,0,0,0,0,0,0,0,0
1963,68312479,2683100,2683150,1247900,1247950,0,0,0,0,0,0,0,0,0,0,0,0,0,0,0
1964,68322475,2683200,2683250,1247500,1247550,6,3,3,3,3,0,18,3,3,4,3,3,0,16,34
1965,68322489,2683200,2683250,1248900,1248950,5,3,0,3,0,0,11,6,5,7,3,0,3,24,35
1966,68322471,2683200,2683250,1247100,1247150,0,3,0,0,0,0,3,3,3,0,3,0,0,9,12
1967,68322484,2683200,2683250,1248400,1248450,3,3,3,0,0,0,9,3,3,0,0,0,0,6,15
1968,68332500,2683300,2683350,1250000,1250050,4,4,0,3,3,0,14,6,3,3,3,3,0,18,32
1969,68332497,2683300,2683350,1249700,1249750,3,3,4,3,0,3,16,4,5,3,0,3,0,15,31
1970,68332484,2683300,2683350,1248400,1248450,3,0,0,0,3,0,6,0,3,3,3,0,3,12,18
1971,68342538,2683400,2683450,1253800,1253850,0,0,0,3,3,0,6,3,0,3,3,0,0,9,15
1972,68342475,2683400,2683450,1247500,1247550,3,6,0,3,0,0,12,3,3,3,3,3,3,18,30
1973,68342487,2683400,2683450,1248700,1248750,4,3,3,3,0,0,13,3,0,3,3,0,3,12,25
1974,68342510,2683400,2683450,1251000,1251050,3,3,3,0,0,3,12,3,3,3,3,3,3,18,30
1975,68342498,2683400,2683450,1249800,1249850,0,0,0,0,0,0,0,0,0,0,0,0,0,0,0
1976,68352505,2683500,2683550,1250500,1250550,0,0,3,3,3,3,12,3,4,3,0,3,0,13,25
1977,68352517,2683500,2683550,1251700,1251750,3,3,0,0,0,0,6,3,3,3,0,0,0,9,15
1978,68352470,2683500,2683550,1247000,1247050,17,7,6,6,3,0,39,4,5,6,3,3,3,24,63
1979,68352481,2683500,2683550,1248100,1248150,0,3,3,0,0,0,6,3,3,0,0,0,3,9,15
1980,68352484,2683500,2683550,1248400,1248450,3,3,0,3,0,0,9,0,3,3,3,3,0,12,21
1981,68362491,2683600,2683650,1249100,1249150,3,3,3,0,3,0,12,4,3,3,3,3,3,19,31
1982,68362516,2683600,2683650,1251600,1251650,0,0,3,0,0,0,3,3,3,3,0,0,0,9,12
1983,68362485,2683600,2683650,1248500,1248550,0,4,3,0,3,0,10,3,4,3,3,3,3,19,29
1984,68372494,2683700,2683750,1249400,1249450,3,3,3,0,0,0,9,0,3,3,0,3,0,9,18
1985,68372512,2683700,2683750,1251200,1251250,3,0,0,0,0,0,3,3,0,0,0,3,0,6,9
1986,68372528,2683700,2683750,1252800,1252850,3,6,3,0,3,0,15,8,3,3,0,3,3,20,35
1987,68372514,2683700,2683750,1251400,1251450,3,3,4,3,0,3,16,7,7,3,3,6,3,29,45
1988,68372536,2683700,2683750,1253600,1253650,3,0,0,0,0,0,3,3,0,3,0,0,0,6,9
1989,68382521,2683800,2683850,1252100,1252150,0,0,0,0,0,0,0,0,0,0,0,0,0,0,0
1990,68392536,2683900,2683950,1253600,1253650,3,9,4,3,0,0,19,3,9,3,3,3,0,21,40
1991,68402483,2684000,2684050,1248300,1248350,3,3,3,0,0,0,9,4,3,3,4,0,0,14,23
1992,68402459,2684000,2684050,1245900,1245950,0,3,0,0,0,0,3,3,0,0,0,0,0,3,6
1993,68402536,2684000,2684050,1253600,1253650,3,0,3,3,3,0,12,3,6,3,3,0,0,15,27
1994,68412482,2684100,2684150,1248200,1248250,3,3,3,3,0,0,12,3,0,8,6,4,3,24,36
1995,68422461,2684200,2684250,1246100,1246150,3,3,0,0,0,3,9,3,0,0,3,0,0,6,15
1996,68422482,2684200,2684250,1248200,1248250,0,0,0,3,0,0,3,0,3,3,0,0,0,6,9
1997,68422490,2684200,2684250,1249000,1249050,3,0,3,0,0,0,6,3,0,3,0,3,0,9,15
1998,68422491,2684200,2684250,1249100,1249150,0,0,0,0,0,0,0,0,0,0,0,0,0,0,0
1999,68422455,2684200,2684250,1245500,1245550,3,3,3,6,4,3,22,3,7,11,19,4,7,51,73
2000,68422537,2684200,2684250,1253700,1253750,3,0,0,3,0,0,6,3,0,0,0,0,0,3,9
2001,68432484,2684300,2684350,1248400,1248450,3,4,3,3,0,3,16,3,6,3,4,0,0,16,32
2002,68442510,2684400,2684450,1251000,1251050,3,0,3,0,0,0,6,3,0,0,3,0,0,6,12
2003,68442486,2684400,2684450,1248600,1248650,0,0,0,3,3,0,6,3,0,3,3,3,0,12,18
2004,68442508,2684400,2684450,1250800,1250850,0,3,3,3,0,3,12,3,3,3,3,3,0,15,27
2005,68442483,2684400,2684450,1248300,1248350,0,0,0,3,0,0,3,0,0,3,3,0,0,6,9
2006,68452459,2684500,2684550,1245900,1245950,3,3,0,0,0,0,6,3,0,0,3,3,0,9,15
2007,68452488,2684500,2684550,1248800,1248850,0,3,3,3,0,3,12,0,3,3,3,0,0,9,21
2008,68452522,2684500,2684550,1252200,1252250,0,0,0,0,0,0,0,0,0,0,0,0,0,0,0
2009,68462485,2684600,2684650,1248500,1248550,0,3,3,3,0,0,9,3,3,3,3,0,0,12,21
2010,68462513,2684600,2684650,1251300,1251350,0,3,3,3,3,0,12,3,3,3,3,0,3,15,27
2011,68462521,2684600,2684650,1252100,1252150,3,3,0,3,0,0,9,3,3,3,0,0,0,9,18
2012,68462480,2684600,2684650,1248000,1248050,3,3,0,0,0,0,6,0,3,0,0,3,0,6,12
2013,68462475,2684600,2684650,1247500,1247550,3,0,3,0,0,0,6,0,0,3,0,0,0,3,9
2014,68472460,2684700,2684750,1246000,1246050,0,3,5,3,0,3,14,3,3,3,3,3,3,18,32
2015,68472516,2684700,2684750,1251600,1251650,3,3,0,3,3,0,12,3,7,3,3,3,3,22,34
2016,68482511,2684800,2684850,1251100,1251150,3,3,0,0,0,0,6,0,3,0,0,0,0,3,9
2017,68482469,2684800,2684850,1246900,1246950,5,3,3,0,0,0,11,3,5,3,0,0,3,14,25
2018,68492453,2684900,2684950,1245300,1245350,0,3,0,3,0,0,6,3,0,0,0,0,0,3,9
2019,68502466,2685000,2685050,1246600,1246650,0,0,0,0,0,0,0,3,0,0,0,3,0,6,6
2020,68502463,2685000,2685050,1246300,1246350,0,0,0,0,0,0,0,3,0,0,0,0,0,3,3
2021,68502473,2685000,2685050,1247300,1247350,3,3,3,3,3,0,15,3,3,3,3,3,0,15,30
2022,68502460,2685000,2685050,1246000,1246050,4,3,3,3,3,0,16,3,3,3,3,3,0,15,31
2023,68512447,2685100,2685150,1244700,1244750,3,0,0,0,3,0,6,3,3,0,3,0,0,9,15
2024,68522513,2685200,2685250,1251300,1251350,3,3,5,3,0,0,14,3,4,3,3,3,0,16,30
2025,68522459,2685200,2685250,1245900,1245950,3,3,0,0,3,0,9,3,3,3,3,0,3,15,24
2026,68532447,2685300,2685350,1244700,1244750,0,0,3,3,0,0,6,0,3,0,3,0,0,6,12
2027,68532519,2685300,2685350,1251900,1251950,0,3,0,0,0,0,3,0,0,0,0,0,0,0,3
2028,68542523,2685400,2685450,1252300,1252350,0,0,3,0,0,0,3,0,3,0,0,0,0,3,6
2029,68542481,2685400,2685450,1248100,1248150,3,3,3,0,0,0,9,3,3,0,3,3,0,12,21
2030,68542472,2685400,2685450,1247200,1247250,0,0,0,0,0,0,0,0,0,0,0,0,0,0,0
2031,68552482,2685500,2685550,1248200,1248250,0,0,3,0,0,0,3,0,0,0,0,3,0,3,6
2032,68552506,2685500,2685550,1250600,1250650,0,0,0,0,0,3,3,0,0,0,0,0,0,0,3
2033,68562466,2685600,2685650,1246600,1246650,0,0,0,0,0,0,0,3,0,3,0,0,0,6,6
2034,68572487,2685700,2685750,1248700,1248750,0,0,0,0,0,0,0,0,0,0,0,0,0,0,0
2035,68572510,2685700,2685750,1251000,1251050,3,0,3,3,0,0,9,0,3,0,3,3,3,12,21
2036,68582447,2685800,2685850,1244700,1244750,3,3,3,0,0,3,12,3,3,3,0,3,0,12,24
2037,68602512,2686000,2686050,1251200,1251250,3,0,3,3,0,3,12,3,3,3,0,0,0,9,21
2038,68602448,2686000,2686050,1244800,1244850,0,3,0,0,0,0,3,3,3,3,3,0,0,12,15
2039,68612515,2686100,2686150,1251500,1251550,5,3,0,3,0,0,11,3,3,0,3,3,0,12,23
2040,68612513,2686100,2686150,1251300,1251350,5,4,3,3,3,0,18,6,5,3,4,3,3,24,42
2041,68622462,2686200,2686250,1246200,1246250,3,3,0,3,3,0,12,3,0,3,3,0,0,9,21
2042,68622452,2686200,2686250,1245200,1245250,0,0,3,0,0,0,3,3,3,0,0,0,0,6,9
2043,68632507,2686300,2686350,1250700,1250750,0,3,3,0,0,0,6,0,3,4,0,0,3,10,16
2044,68632506,2686300,2686350,1250600,1250650,0,3,0,0,0,0,3,3,3,0,3,0,3,12,15
2045,68692457,2686900,2686950,1245700,1245750,3,3,3,3,3,3,18,3,4,3,3,3,3,19,37
2046,68692460,2686900,2686950,1246000,1246050,3,3,3,3,3,0,15,4,3,4,3,3,3,20,35
2047,68692510,2686900,2686950,1251000,1251050,3,5,0,0,0,0,8,4,3,0,0,0,0,7,15
2048,68702506,2687000,2687050,1250600,1250650,3,0,0,0,0,0,3,3,0,3,3,0,3,12,15
2049,68712502,2687100,2687150,1250200,1250250,3,0,0,0,0,0,3,0,0,0,0,0,0,0,3
2050,68722512,2687200,2687250,1251200,1251250,3,0,3,0,0,0,6,3,3,3,0,3,3,15,21
2051,68752460,2687500,2687550,1246000,1246050,3,3,3,0,0,3,12,3,3,4,3,0,3,16,28
2052,68752462,2687500,2687550,1246200,1246250,0,0,3,0,0,0,3,0,0,3,0,0,3,6,9
2053,68762456,2687600,2687650,1245600,1245650,3,3,3,0,3,0,12,3,3,3,3,0,0,12,24
2054,68772458,2687700,2687750,1245800,1245850,0,0,3,3,3,3,12,0,0,3,3,3,3,12,24
2055,68782463,2687800,2687850,1246300,1246350,3,3,3,3,0,0,12,3,3,3,0,0,3,12,24
2056,68002505,2680000,2680050,1250500,1250550,4,0,3,3,3,3,16,4,5,4,3,3,3,22,38
2057,68002458,2680000,2680050,1245800,1245850,0,3,3,3,0,0,9,3,0,3,3,0,0,9,18
2058,68012483,2680100,2680150,1248300,1248350,3,3,0,0,0,0,6,3,0,0,3,0,3,9,15
2059,68012506,2680100,2680150,1250600,1250650,3,0,3,0,0,3,9,3,0,3,3,0,0,9,18
2060,68012503,2680100,2680150,1250300,1250350,0,0,3,0,0,0,3,3,3,0,0,0,0,6,9
2061,68012478,2680100,2680150,1247800,1247850,8,7,5,5,4,3,32,7,6,7,4,3,3,30,62
2062,68012468,2680100,2680150,1246800,1246850,3,0,3,3,3,0,12,3,3,3,0,3,3,15,27
2063,68012480,2680100,2680150,1248000,1248050,0,0,0,0,0,0,0,0,0,0,0,0,0,0,0
2064,68022471,2680200,2680250,1247100,1247150,3,3,3,0,3,3,15,5,7,9,3,3,3,30,45
2065,68022484,2680200,2680250,1248400,1248450,0,0,0,0,0,0,0,0,0,0,0,0,0,0,0
2066,68032508,2680300,2680350,1250800,1250850,3,0,3,3,0,3,12,0,0,5,3,0,3,11,23
2067,68032466,2680300,2680350,1246600,1246650,4,3,3,0,3,0,13,3,3,3,0,3,0,12,25
2068,68032467,2680300,2680350,1246700,1246750,3,3,3,3,3,0,15,3,4,6,3,0,3,19,34
2069,68032475,2680300,2680350,1247500,1247550,3,3,3,3,0,0,12,3,3,4,3,4,3,20,32
2070,68032474,2680300,2680350,1247400,1247450,3,3,3,3,3,3,18,5,3,3,4,3,3,21,39
2071,68032482,2680300,2680350,1248200,1248250,3,3,3,0,3,3,15,5,3,3,3,3,5,22,37
2072,68042505,2680400,2680450,1250500,1250550,3,4,0,3,0,3,13,3,3,3,3,0,3,15,28
2073,68052467,2680500,2680550,1246700,1246750,0,0,0,0,0,0,0,0,0,0,0,0,0,0,0
2074,68062524,2680600,2680650,1252400,1252450,3,3,3,3,0,0,12,4,3,4,3,3,3,20,32
2075,68062463,2680600,2680650,1246300,1246350,3,0,0,0,0,3,6,0,0,3,0,3,0,6,12
2076,68072522,2680700,2680750,1252200,1252250,3,0,0,0,3,0,6,4,3,3,3,3,0,16,22
2077,68072498,2680700,2680750,1249800,1249850,3,0,3,0,0,0,6,3,3,0,0,0,3,9,15
2078,68072467,2680700,2680750,1246700,1246750,3,4,3,3,3,0,16,5,3,0,3,4,3,18,34
2079,68072459,2680700,2680750,1245900,1245950,3,3,3,3,3,0,15,3,7,3,3,4,0,20,35
2080,68072525,2680700,2680750,1252500,1252550,3,3,0,0,3,0,9,3,3,3,0,3,3,15,24
2081,68072465,2680700,2680750,1246500,1246550,3,3,0,0,0,0,6,3,0,0,0,0,3,6,12
2082,68082469,2680800,2680850,1246900,1246950,0,3,0,3,3,0,9,3,3,5,4,3,3,21,30
2083,68082487,2680800,2680850,1248700,1248750,3,3,3,3,0,0,12,4,3,3,3,0,0,13,25
2084,68082451,2680800,2680850,1245100,1245150,0,0,0,0,0,0,0,0,0,0,0,0,0,0,0
2085,68082525,2680800,2680850,1252500,1252550,5,4,4,4,3,3,23,7,4,7,6,4,3,31,54
2086,68092456,2680900,2680950,1245600,1245650,3,4,3,3,3,0,16,3,3,3,3,0,0,12,28
2087,68092525,2680900,2680950,1252500,1252550,3,3,3,0,3,0,12,0,3,3,0,3,0,9,21
2088,68092466,2680900,2680950,1246600,1246650,5,3,3,3,3,3,20,3,3,3,6,9,3,27,47
2089,68092472,2680900,2680950,1247200,1247250,3,3,3,0,3,0,12,6,3,4,3,0,0,16,28
2090,68102524,2681000,2681050,1252400,1252450,0,3,3,3,3,0,12,3,3,3,3,3,3,18,30
2091,68102476,2681000,2681050,1247600,1247650,0,0,0,0,0,0,0,3,0,0,0,0,0,3,3
2092,68112453,2681100,2681150,1245300,1245350,0,3,0,3,0,0,6,0,0,0,3,0,0,3,9
2093,68112431,2681100,2681150,1243100,1243150,0,0,0,0,0,0,0,0,0,0,0,0,0,0,0
2094,68112429,2681100,2681150,1242900,1242950,0,0,0,0,0,0,0,0,0,0,0,0,0,0,0
2095,68132475,2681300,2681350,1247500,1247550,0,3,3,0,3,0,9,3,0,0,0,0,0,3,12
2096,68142479,2681400,2681450,1247900,1247950,7,4,5,3,3,3,25,10,7,4,3,3,0,27,52
2097,68142468,2681400,2681450,1246800,1246850,3,3,3,0,3,0,12,3,3,3,3,3,0,15,27
2098,68152468,2681500,2681550,1246800,1246850,3,0,0,0,0,0,3,0,0,0,0,3,0,3,6
2099,68152430,2681500,2681550,1243000,1243050,3,3,3,3,0,0,12,3,3,3,0,0,0,9,21
2100,68152419,2681500,2681550,1241900,1241950,0,0,0,0,0,3,3,0,0,0,0,0,0,0,3
2101,68152518,2681500,2681550,1251800,1251850,0,0,0,0,0,0,0,0,0,0,0,0,0,0,0
2102,68162494,2681600,2681650,1249400,1249450,0,3,0,0,0,0,3,0,3,3,0,0,0,6,9
2103,68162482,2681600,2681650,1248200,1248250,4,0,3,0,0,0,7,0,0,0,0,0,0,0,7
2104,68172491,2681700,2681750,1249100,1249150,3,3,0,0,0,0,6,0,0,0,0,0,0,0,6
2105,68182472,2681800,2681850,1247200,1247250,0,3,0,3,0,0,6,0,3,0,0,3,3,9,15
2106,68182465,2681800,2681850,1246500,1246550,6,3,3,3,3,0,18,4,3,0,3,3,0,13,31
2107,68192497,2681900,2681950,1249700,1249750,3,3,3,0,0,0,9,3,3,3,3,0,0,12,21
2108,68192477,2681900,2681950,1247700,1247750,3,0,0,0,0,0,3,0,0,0,0,0,0,0,3
2109,68192489,2681900,2681950,1248900,1248950,3,3,0,3,0,0,9,0,0,3,0,0,3,6,15
2110,68192458,2681900,2681950,1245800,1245850,0,0,0,0,0,0,0,0,0,0,0,0,0,0,0
2111,68192493,2681900,2681950,1249300,1249350,0,0,0,0,0,0,0,0,0,0,0,0,0,0,0
2112,68192446,2681900,2681950,1244600,1244650,0,0,0,0,0,0,0,0,0,0,0,0,0,0,0
2113,68202475,2682000,2682050,1247500,1247550,4,3,4,3,0,0,14,7,4,3,0,0,0,14,28
2114,68202470,2682000,2682050,1247000,1247050,0,0,3,0,0,0,3,0,0,3,3,0,0,6,9
2115,68212438,2682100,2682150,1243800,1243850,0,0,3,3,3,3,12,3,3,3,4,3,3,19,31
2116,68212474,2682100,2682150,1247400,1247450,3,3,3,0,0,0,9,3,3,0,0,3,0,9,18
2117,68212482,2682100,2682150,1248200,1248250,8,7,5,3,3,0,26,3,6,3,3,0,0,15,41
2118,68222460,2682200,2682250,1246000,1246050,3,3,3,3,0,0,12,0,3,3,3,0,0,9,21
2119,68222473,2682200,2682250,1247300,1247350,3,0,0,0,3,0,6,3,0,3,0,0,0,6,12
2120,68232520,2682300,2682350,1252000,1252050,3,3,3,3,0,0,12,3,3,3,0,3,0,12,24
2121,68232483,2682300,2682350,1248300,1248350,0,0,0,0,0,0,0,0,0,0,0,0,0,0,0
2122,68232448,2682300,2682350,1244800,1244850,7,3,3,3,0,0,16,4,3,3,0,3,3,16,32
2123,68242477,2682400,2682450,1247700,1247750,3,3,3,0,3,0,12,0,3,3,3,0,0,9,21
2124,68252523,2682500,2682550,1252300,1252350,3,0,3,0,0,0,6,3,3,3,3,0,0,12,18
2125,68252500,2682500,2682550,1250000,1250050,3,3,0,3,0,0,9,3,3,3,3,3,0,15,24
2126,68252436,2682500,2682550,1243600,1243650,3,3,0,0,0,0,6,3,3,3,3,0,0,12,18
2127,68252443,2682500,2682550,1244300,1244350,4,3,6,3,6,3,25,6,7,7,13,9,9,51,76
2128,68262486,2682600,2682650,1248600,1248650,4,3,0,0,0,0,7,0,3,0,0,0,0,3,10
2129,68262449,2682600,2682650,1244900,1244950,0,3,0,3,3,0,9,3,0,0,3,3,0,9,18
2130,68262516,2682600,2682650,1251600,1251650,3,3,3,0,0,0,9,3,6,3,3,3,0,18,27
2131,68262432,2682600,2682650,1243200,1243250,3,3,3,3,3,3,18,3,0,4,3,0,3,13,31
2132,68262467,2682600,2682650,1246700,1246750,3,3,0,0,0,0,6,3,3,0,0,0,3,9,15
2133,68262470,2682600,2682650,1247000,1247050,0,0,0,0,0,0,0,0,3,0,0,0,0,3,3
2134,68272495,2682700,2682750,1249500,1249550,3,3,0,0,3,0,9,3,3,0,0,3,0,9,18
2135,68272499,2682700,2682750,1249900,1249950,4,3,3,3,3,3,19,9,3,3,3,3,3,24,43
2136,68272471,2682700,2682750,1247100,1247150,3,0,0,0,0,0,3,3,0,0,0,0,0,3,6
2137,68272478,2682700,2682750,1247800,1247850,3,0,0,3,0,0,6,0,0,0,0,0,0,0,6
2138,68272536,2682700,2682750,1253600,1253650,3,0,3,0,3,0,9,3,0,3,3,0,0,9,18
2139,68272530,2682700,2682750,1253000,1253050,0,3,3,0,3,0,9,3,0,0,3,3,0,9,18
2140,68282428,2682800,2682850,1242800,1242850,4,0,3,3,3,0,13,3,5,5,0,3,3,19,32
2141,68282503,2682800,2682850,1250300,1250350,5,5,5,3,0,0,18,4,3,3,3,3,3,19,37
2142,68282516,2682800,2682850,1251600,1251650,4,3,0,0,0,3,10,3,3,3,0,3,0,12,22
2143,68282533,2682800,2682850,1253300,1253350,0,3,3,3,0,0,9,3,3,0,3,0,0,9,18
2144,68282435,2682800,2682850,1243500,1243550,3,3,3,0,0,0,9,3,0,0,0,3,3,9,18
2145,68282454,2682800,2682850,1245400,1245450,0,0,0,0,0,0,0,0,0,0,0,0,0,0,0
2146,68282506,2682800,2682850,1250600,1250650,0,0,3,0,0,3,6,0,0,0,3,0,3,6,12
2147,68282514,2682800,2682850,1251400,1251450,3,0,0,3,0,0,6,4,0,3,0,3,3,13,19
2148,68282482,2682800,2682850,1248200,1248250,3,0,0,0,0,0,3,0,0,0,0,0,0,0,3
2149,68282525,2682800,2682850,1252500,1252550,3,0,0,3,3,0,9,3,0,3,3,3,3,15,24
2150,68282513,2682800,2682850,1251300,1251350,0,0,0,0,0,0,0,0,3,0,0,0,0,3,3
2151,68282520,2682800,2682850,1252000,1252050,0,0,3,0,0,0,3,0,3,0,0,0,0,3,6
2152,68282437,2682800,2682850,1243700,1243750,3,0,0,0,0,0,3,0,0,0,0,0,0,0,3
2153,68292491,2682900,2682950,1249100,1249150,3,4,3,0,0,3,13,3,3,3,3,3,0,15,28
2154,68292435,2682900,2682950,1243500,1243550,3,3,0,0,0,3,9,3,3,3,3,3,0,15,24
2155,68292474,2682900,2682950,1247400,1247450,0,0,0,0,0,0,0,0,0,0,0,0,0,0,0
2156,68292507,2682900,2682950,1250700,1250750,0,3,0,0,0,0,3,0,0,3,0,0,3,6,9
2157,68292539,2682900,2682950,1253900,1253950,3,3,3,0,3,3,15,3,3,0,3,3,0,12,27
2158,68292532,2682900,2682950,1253200,1253250,3,0,3,3,0,0,9,0,3,3,3,3,0,12,21
2159,68302534,2683000,2683050,1253400,1253450,3,0,0,0,0,0,3,0,0,0,0,0,0,0,3
2160,68312471,2683100,2683150,1247100,1247150,67,53,39,21,19,20,219,51,48,44,57,81,102,383,602
2161,68312491,2683100,2683150,1249100,1249150,3,3,3,3,0,0,12,0,3,3,3,3,3,15,27
2162,68312512,2683100,2683150,1251200,1251250,0,0,0,3,0,0,3,0,0,0,3,0,0,3,6
2163,68312498,2683100,2683150,1249800,1249850,3,3,5,3,0,3,17,6,3,5,0,3,3,20,37
2164,68312539,2683100,2683150,1253900,1253950,0,3,3,4,0,3,13,3,3,3,0,3,0,12,25
2165,68312435,2683100,2683150,1243500,1243550,0,3,0,0,0,0,3,0,3,0,0,0,0,3,6
2166,68312510,2683100,2683150,1251000,1251050,0,0,0,0,0,0,0,0,0,3,0,0,0,3,3
2167,68312429,2683100,2683150,1242900,1242950,0,0,0,0,0,0,0,3,0,0,0,0,0,3,3
2168,68322500,2683200,2683250,1250000,1250050,7,3,3,0,3,0,16,3,4,5,3,3,3,21,37
2169,68322534,2683200,2683250,1253400,1253450,3,3,0,0,0,0,6,3,0,0,0,0,0,3,9
2170,68322516,2683200,2683250,1251600,1251650,0,3,0,0,0,0,3,0,0,0,0,0,0,0,3
2171,68322526,2683200,2683250,1252600,1252650,0,0,0,0,0,0,0,0,0,0,0,0,0,0,0
2172,68332535,2683300,2683350,1253500,1253550,3,3,3,3,0,0,12,3,0,3,3,0,0,9,21
2173,68332498,2683300,2683350,1249800,1249850,3,3,0,3,0,0,9,3,3,3,0,0,0,9,18
2174,68342525,2683400,2683450,1252500,1252550,3,3,0,0,0,3,9,5,3,3,0,0,3,14,23
2175,68342524,2683400,2683450,1252400,1252450,3,9,7,3,0,0,22,6,6,8,4,3,3,30,52
2176,68352494,2683500,2683550,1249400,1249450,3,3,3,0,3,0,12,3,3,3,4,3,0,16,28
2177,68352473,2683500,2683550,1247300,1247350,7,5,7,3,3,3,28,3,4,3,5,3,0,18,46
2178,68352534,2683500,2683550,1253400,1253450,0,3,3,0,0,0,6,0,0,3,3,0,3,9,15
2179,68362506,2683600,2683650,1250600,1250650,0,0,0,0,3,0,3,0,3,0,0,3,0,6,9
2180,68362538,2683600,2683650,1253800,1253850,3,3,0,0,0,0,6,3,0,0,0,0,0,3,9
2181,68362470,2683600,2683650,1247000,1247050,3,0,3,0,0,0,6,3,3,0,0,0,0,6,12
2182,68362509,2683600,2683650,1250900,1250950,3,3,3,3,3,0,15,3,3,3,0,0,3,12,27
2183,68362513,2683600,2683650,1251300,1251350,3,0,3,3,0,0,9,3,3,3,3,0,3,15,24
2184,68362525,2683600,2683650,1252500,1252550,3,3,0,3,0,0,9,3,3,0,0,0,0,6,15
2185,68362534,2683600,2683650,1253400,1253450,0,5,0,3,0,0,8,3,3,3,0,0,0,9,17
2186,68362497,2683600,2683650,1249700,1249750,3,3,8,3,15,4,36,3,7,16,19,33,36,114,150
2187,68372529,2683700,2683750,1252900,1252950,4,7,3,4,3,3,24,11,5,5,3,4,3,31,55
2188,68372471,2683700,2683750,1247100,1247150,3,0,0,0,0,0,3,3,0,0,0,0,0,3,6
2189,68372497,2683700,2683750,1249700,1249750,0,3,3,3,3,3,15,0,4,6,9,5,5,29,44
2190,68382493,2683800,2683850,1249300,1249350,3,3,3,3,3,3,18,4,0,3,0,3,0,10,28
2191,68382469,2683800,2683850,1246900,1246950,0,0,0,0,0,0,0,0,0,0,0,0,0,0,0
2192,68382468,2683800,2683850,1246800,1246850,0,0,0,0,0,0,0,3,3,0,0,0,0,6,6
2193,68392535,2683900,2683950,1253500,1253550,3,4,4,3,3,0,17,7,3,3,4,4,0,21,38
2194,68392467,2683900,2683950,1246700,1246750,0,0,0,0,0,0,0,0,0,0,0,0,0,0,0
2195,68392457,2683900,2683950,1245700,1245750,0,0,0,0,0,3,3,0,0,0,0,3,0,3,6
2196,68402461,2684000,2684050,1246100,1246150,4,3,4,3,3,0,17,3,3,5,3,3,3,20,37
2197,68402466,2684000,2684050,1246600,1246650,0,0,0,0,0,0,0,0,0,0,0,3,0,3,3
2198,68402491,2684000,2684050,1249100,1249150,3,4,0,3,3,0,13,0,0,3,3,0,0,6,19
2199,68402530,2684000,2684050,1253000,1253050,3,0,0,3,3,0,9,0,3,3,3,3,3,15,24
2200,68402486,2684000,2684050,1248600,1248650,3,3,3,0,0,0,9,3,3,3,3,0,0,12,21
2201,68402498,2684000,2684050,1249800,1249850,3,0,0,3,0,0,6,3,0,3,3,0,0,9,15
2202,68402457,2684000,2684050,1245700,1245750,0,0,0,0,0,0,0,0,0,0,0,0,0,0,0
2203,68402456,2684000,2684050,1245600,1245650,0,0,0,0,0,0,0,0,0,0,0,0,0,0,0
2204,68412481,2684100,2684150,1248100,1248150,3,3,5,3,0,0,14,3,3,3,0,0,3,12,26
2205,68412467,2684100,2684150,1246700,1246750,3,4,3,3,3,3,19,3,3,3,0,0,3,12,31
2206,68412485,2684100,2684150,1248500,1248550,0,3,0,0,0,0,3,3,3,3,3,3,0,15,18
2207,68412484,2684100,2684150,1248400,1248450,3,3,3,3,0,0,12,3,3,3,3,3,0,15,27
2208,68412514,2684100,2684150,1251400,1251450,3,3,0,0,3,3,12,3,3,3,0,0,0,9,21
2209,68412455,2684100,2684150,1245500,1245550,0,0,3,0,0,0,3,0,3,0,3,0,0,6,9
2210,68422456,2684200,2684250,1245600,1245650,4,4,3,3,3,3,20,4,5,5,3,3,0,20,40
2211,68422535,2684200,2684250,1253500,1253550,3,3,0,0,3,0,9,0,3,0,0,3,0,6,15
2212,68432506,2684300,2684350,1250600,1250650,0,0,0,0,0,0,0,0,0,0,0,0,0,0,0
2213,68432479,2684300,2684350,1247900,1247950,3,3,0,3,0,0,9,3,3,3,3,0,0,12,21
2214,68432490,2684300,2684350,1249000,1249050,3,3,0,0,0,0,6,0,0,3,0,0,0,3,9
2215,68432489,2684300,2684350,1248900,1248950,0,0,3,3,3,0,9,3,3,3,3,0,0,12,21
2216,68432459,2684300,2684350,1245900,1245950,3,3,3,3,0,0,12,3,5,3,3,0,0,14,26
2217,68432474,2684300,2684350,1247400,1247450,3,0,0,3,3,0,9,3,3,0,3,0,0,9,18
2218,68442453,2684400,2684450,1245300,1245350,3,3,0,0,3,0,9,7,3,3,3,0,0,16,25
2219,68442465,2684400,2684450,1246500,1246550,5,6,0,3,0,0,14,13,5,7,3,3,3,34,48
2220,68442480,2684400,2684450,1248000,1248050,5,3,0,3,0,0,11,3,4,8,8,3,3,29,40
2221,68442457,2684400,2684450,1245700,1245750,3,3,3,4,0,0,13,4,8,3,3,0,0,18,31
2222,68442520,2684400,2684450,1252000,1252050,3,0,0,0,0,0,3,0,0,3,0,0,0,3,6
2223,68452515,2684500,2684550,1251500,1251550,3,3,0,4,3,3,16,3,3,3,4,3,0,16,32
2224,68452483,2684500,2684550,1248300,1248350,4,4,5,0,3,3,19,5,6,4,8,8,5,36,55
2225,68472477,2684700,2684750,1247700,1247750,0,3,3,3,0,0,9,4,5,4,3,0,0,16,25
2226,68472463,2684700,2684750,1246300,1246350,3,3,3,0,0,3,12,3,3,3,0,0,0,9,21
2227,68482516,2684800,2684850,1251600,1251650,3,3,3,0,0,0,9,3,3,3,3,3,0,15,24
2228,68482476,2684800,2684850,1247600,1247650,3,0,3,0,0,0,6,0,3,0,0,0,0,3,9
2229,68482465,2684800,2684850,1246500,1246550,3,3,0,3,0,0,9,0,3,0,0,3,0,6,15
2230,68492454,2684900,2684950,1245400,1245450,0,0,3,3,0,3,9,0,3,0,3,3,7,16,25
2231,68492452,2684900,2684950,1245200,1245250,3,3,0,0,0,0,6,3,0,3,0,0,0,6,12
2232,68512511,2685100,2685150,1251100,1251150,4,4,3,3,3,3,20,4,4,6,3,3,3,23,43
2233,68512509,2685100,2685150,1250900,1250950,3,3,3,3,0,0,12,3,3,3,3,3,0,15,27
2234,68512455,2685100,2685150,1245500,1245550,0,3,0,0,0,0,3,0,0,0,0,0,0,0,3
2235,68512451,2685100,2685150,1245100,1245150,3,0,0,0,0,0,3,4,0,0,0,0,0,4,7
2236,68512483,2685100,2685150,1248300,1248350,0,0,0,0,0,3,3,0,0,0,0,0,3,3,6
2237,68512457,2685100,2685150,1245700,1245750,0,0,0,0,0,0,0,0,3,0,0,0,0,3,3
2238,68522509,2685200,2685250,1250900,1250950,3,3,0,0,0,0,6,0,3,3,0,0,0,6,12
2239,68522516,2685200,2685250,1251600,1251650,3,0,0,0,0,0,3,0,0,0,0,0,0,0,3
2240,68522448,2685200,2685250,1244800,1244850,0,3,0,0,0,0,3,0,0,0,0,0,0,0,3
2241,68522464,2685200,2685250,1246400,1246450,3,3,0,3,3,0,12,3,3,3,0,3,0,12,24
2242,68522469,2685200,2685250,1246900,1246950,0,3,0,0,0,0,3,0,0,0,0,0,0,0,3
2243,68532508,2685300,2685350,1250800,1250850,3,3,3,0,3,0,12,3,3,3,3,0,0,12,24
2244,68542466,2685400,2685450,1246600,1246650,3,0,3,0,3,0,9,3,0,3,3,0,3,12,21
2245,68542509,2685400,2685450,1250900,1250950,3,0,0,3,0,0,6,0,0,3,0,0,0,3,9
2246,68542461,2685400,2685450,1246100,1246150,3,3,3,0,3,0,12,4,4,3,3,0,0,14,26
2247,68542462,2685400,2685450,1246200,1246250,3,3,0,0,3,0,9,3,0,0,4,0,0,7,16
2248,68542459,2685400,2685450,1245900,1245950,3,0,0,0,0,0,3,0,0,0,0,0,0,0,3
2249,68552473,2685500,2685550,1247300,1247350,0,3,0,0,0,0,3,3,0,0,0,0,0,3,6
2250,68552474,2685500,2685550,1247400,1247450,3,0,0,0,0,0,3,0,0,0,0,0,0,0,3
2251,68562486,2685600,2685650,1248600,1248650,0,0,0,0,0,0,0,0,0,0,0,0,0,0,0
2252,68592512,2685900,2685950,1251200,1251250,4,3,3,3,0,0,13,6,3,3,3,0,0,15,28
2253,68592514,2685900,2685950,1251400,1251450,3,3,0,0,0,0,6,5,3,3,0,0,0,11,17
2254,68592506,2685900,2685950,1250600,1250650,0,0,0,0,0,0,0,0,0,0,0,0,0,0,0
2255,68592511,2685900,2685950,1251100,1251150,3,3,3,3,0,0,12,5,3,3,0,0,0,11,23
2256,68592459,2685900,2685950,1245900,1245950,3,3,3,0,0,0,9,0,3,0,0,0,0,3,12
2257,68592507,2685900,2685950,1250700,1250750,3,0,0,0,0,0,3,3,0,0,0,0,0,3,6
2258,68622456,2686200,2686250,1245600,1245650,4,3,3,0,0,0,10,3,3,3,0,3,0,12,22
2259,68622461,2686200,2686250,1246100,1246150,4,3,3,0,0,0,10,3,3,3,3,3,0,15,25
2260,68652510,2686500,2686550,1251000,1251050,3,3,3,3,3,0,15,7,3,5,0,0,0,15,30
2261,68652457,2686500,2686550,1245700,1245750,0,3,3,0,0,0,6,3,3,3,0,0,0,9,15
2262,68662504,2686600,2686650,1250400,1250450,0,0,0,0,0,0,0,0,0,0,0,0,0,0,0
2263,68662505,2686600,2686650,1250500,1250550,0,0,0,0,0,0,0,0,0,0,3,0,0,3,3
2264,68662487,2686600,2686650,1248700,1248750,0,0,0,0,0,0,0,0,0,0,0,0,0,0,0
2265,68662514,2686600,2686650,1251400,1251450,3,3,3,3,3,0,15,0,3,4,3,3,3,16,31
2266,68682458,2686800,2686850,1245800,1245850,3,0,3,3,0,0,9,4,3,5,3,3,0,18,27
2267,68712484,2687100,2687150,1248400,1248450,0,3,0,0,0,0,3,0,0,3,0,0,0,3,6
2268,68722463,2687200,2687250,1246300,1246350,0,0,0,3,0,0,3,3,3,0,0,0,0,6,9
2269,68762457,2687600,2687650,1245700,1245750,0,3,4,3,3,3,16,3,3,7,3,3,3,22,38
2270,68762455,2687600,2687650,1245500,1245550,3,3,3,0,0,0,9,3,3,3,3,3,0,15,24
2271,68772461,2687700,2687750,1246100,1246150,3,3,3,0,0,0,9,3,3,3,0,3,0,12,21
2272,67912479,2679100,2679150,1247900,1247950,3,3,0,3,0,0,9,3,3,0,0,0,0,6,15
2273,68442519,2684400,2684450,1251900,1251950,0,0,0,0,0,0,0,0,0,0,0,0,0,0,0
2274,68352501,2683500,2683550,1250100,1250150,0,0,0,0,0,0,0,0,0,0,0,0,0,0,0
2275,67922484,2679200,2679250,1248400,1248450,0,3,0,3,0,0,6,0,3,0,3,3,3,12,18
2276,68132495,2681300,2681350,1249500,1249550,0,0,0,0,0,0,0,0,0,0,0,0,0,0,0
2277,67772491,2677700,2677750,1249100,1249150,3,3,3,3,0,0,12,3,3,4,3,3,3,19,31
2278,67792497,2677900,2677950,1249700,1249750,3,3,0,0,0,0,6,3,0,3,0,0,0,6,12
2279,67792502,2677900,2677950,1250200,1250250,0,0,0,0,0,0,0,0,0,0,0,0,0,0,0
2280,67822493,2678200,2678250,1249300,1249350,0,3,3,0,0,0,6,3,0,3,0,0,0,6,12
2281,67822519,2678200,2678250,1251900,1251950,3,3,3,0,0,0,9,3,3,3,0,0,3,12,21
2282,67832485,2678300,2678350,1248500,1248550,0,0,0,0,0,0,0,0,0,0,0,0,0,0,0
2283,67842484,2678400,2678450,1248400,1248450,3,0,0,0,0,0,3,3,0,3,0,0,3,9,12
2284,67862511,2678600,2678650,1251100,1251150,3,4,5,3,3,3,21,4,6,9,3,5,3,30,51
2285,67872522,2678700,2678750,1252200,1252250,5,3,3,3,0,0,14,3,4,3,3,3,0,16,30
2286,67872485,2678700,2678750,1248500,1248550,3,3,3,3,3,0,15,3,3,4,4,3,3,20,35
2287,67872513,2678700,2678750,1251300,1251350,0,0,0,3,0,0,3,0,0,0,0,0,0,0,3
2288,67882490,2678800,2678850,1249000,1249050,3,6,7,8,7,3,34,10,10,10,12,18,5,65,99
2289,67882515,2678800,2678850,1251500,1251550,12,3,0,0,0,3,18,4,0,0,3,3,3,13,31
2290,67882512,2678800,2678850,1251200,1251250,0,3,3,0,0,0,6,3,3,3,0,3,0,12,18
2291,67892478,2678900,2678950,1247800,1247850,0,0,3,3,0,0,6,3,3,5,3,3,0,17,23
2292,67892484,2678900,2678950,1248400,1248450,0,3,0,0,3,3,9,0,3,3,3,0,0,9,18
2293,67892482,2678900,2678950,1248200,1248250,3,3,0,0,0,0,6,0,0,3,3,0,0,6,12
2294,67892519,2678900,2678950,1251900,1251950,0,3,3,0,0,0,6,0,6,0,0,0,0,6,12
2295,67902478,2679000,2679050,1247800,1247850,7,11,6,6,3,3,36,8,9,3,13,6,0,39,75
2296,67912468,2679100,2679150,1246800,1246850,0,0,3,0,0,0,3,0,3,0,0,0,0,3,6
2297,67912499,2679100,2679150,1249900,1249950,0,0,0,0,0,0,0,0,0,0,0,0,0,0,0
2298,67922508,2679200,2679250,1250800,1250850,3,0,0,0,0,0,3,0,3,0,0,0,0,3,6
2299,67922500,2679200,2679250,1250000,1250050,0,0,3,0,0,0,3,0,0,3,0,0,0,3,6
2300,67922499,2679200,2679250,1249900,1249950,6,3,0,0,0,0,9,3,3,0,3,0,0,9,18
2301,67922483,2679200,2679250,1248300,1248350,3,0,0,0,0,0,3,3,0,0,0,0,0,3,6
2302,67922470,2679200,2679250,1247000,1247050,3,3,3,0,0,0,9,0,3,0,0,3,0,6,15
2303,67932480,2679300,2679350,1248000,1248050,0,0,0,0,0,0,0,0,0,0,0,0,0,0,0
2304,67942468,2679400,2679450,1246800,1246850,3,0,0,0,0,0,3,3,3,3,0,0,3,12,15
2305,67942452,2679400,2679450,1245200,1245250,0,0,0,0,0,0,0,0,0,0,0,0,0,0,0
2306,67942506,2679400,2679450,1250600,1250650,3,3,3,3,3,5,20,3,0,3,3,7,14,30,50
2307,67952468,2679500,2679550,1246800,1246850,3,0,3,0,3,0,9,3,3,3,0,3,3,15,24
2308,67952474,2679500,2679550,1247400,1247450,0,0,3,3,3,0,9,3,3,5,3,3,3,20,29
2309,67952490,2679500,2679550,1249000,1249050,0,0,0,3,3,0,6,0,0,3,3,0,0,6,12
2310,67962508,2679600,2679650,1250800,1250850,3,4,3,3,3,3,19,3,3,0,3,0,3,12,31
2311,67962510,2679600,2679650,1251000,1251050,3,4,3,0,3,0,13,6,3,3,4,0,0,16,29
2312,67962472,2679600,2679650,1247200,1247250,4,3,3,0,3,3,16,3,3,0,3,3,0,12,28
2313,67962512,2679600,2679650,1251200,1251250,3,0,0,0,3,3,9,0,3,3,3,0,3,12,21
2314,67962530,2679600,2679650,1253000,1253050,3,3,4,6,6,0,22,4,11,5,7,6,4,37,59
2315,67972501,2679700,2679750,1250100,1250150,0,0,0,0,0,0,0,0,0,0,0,0,0,0,0
2316,67972528,2679700,2679750,1252800,1252850,0,0,3,0,0,0,3,0,0,3,3,3,3,12,15
2317,67982479,2679800,2679850,1247900,1247950,0,0,0,0,0,0,0,0,0,0,0,0,0,0,0
2318,67992532,2679900,2679950,1253200,1253250,3,3,3,3,0,0,12,3,3,4,0,0,0,10,22
2319,67992527,2679900,2679950,1252700,1252750,0,3,3,3,0,0,9,0,3,3,0,0,0,6,15
2320,67992468,2679900,2679950,1246800,1246850,3,3,3,3,3,5,20,3,5,3,5,10,11,37,57
2321,67992465,2679900,2679950,1246500,1246550,0,3,3,0,3,0,9,3,0,0,3,0,0,6,15
2322,67992464,2679900,2679950,1246400,1246450,3,3,3,3,0,0,12,3,3,5,3,3,3,20,32
2323,67992496,2679900,2679950,1249600,1249650,0,3,0,0,0,0,3,0,0,0,0,0,0,0,3
2324,68002471,2680000,2680050,1247100,1247150,3,3,4,7,4,3,24,3,9,8,3,4,3,30,54
2325,68002465,2680000,2680050,1246500,1246550,3,0,3,3,0,0,9,3,0,3,0,3,3,12,21
2326,68012479,2680100,2680150,1247900,1247950,3,3,3,0,3,0,12,3,3,3,4,0,0,13,25
2327,68012505,2680100,2680150,1250500,1250550,3,3,0,0,3,0,9,3,0,0,3,3,0,9,18
2328,68022478,2680200,2680250,1247800,1247850,3,0,0,3,0,0,6,3,3,3,3,3,0,15,21
2329,68022472,2680200,2680250,1247200,1247250,3,4,3,4,3,3,20,6,8,4,7,6,3,34,54
2330,68022528,2680200,2680250,1252800,1252850,6,3,3,0,3,0,15,3,3,3,3,3,0,15,30
2331,68032527,2680300,2680350,1252700,1252750,4,5,3,3,3,0,18,5,3,3,3,3,0,17,35
2332,68032531,2680300,2680350,1253100,1253150,3,0,3,0,0,0,6,3,3,3,3,0,0,12,18
2333,68032473,2680300,2680350,1247300,1247350,3,3,3,3,3,3,18,3,5,6,6,3,0,23,41
2334,68042464,2680400,2680450,1246400,1246450,3,3,3,0,0,0,9,0,0,0,0,3,0,3,12
2335,68042524,2680400,2680450,1252400,1252450,0,3,3,3,0,0,9,3,0,3,3,0,0,9,18
2336,68042523,2680400,2680450,1252300,1252350,3,3,0,0,0,0,6,3,3,0,0,0,0,6,12
2337,68042481,2680400,2680450,1248100,1248150,3,3,5,0,0,0,11,6,5,3,3,3,0,20,31
2338,68042483,2680400,2680450,1248300,1248350,0,0,3,0,0,0,3,0,0,0,3,0,0,3,6
2339,68052523,2680500,2680550,1252300,1252350,3,0,0,3,0,0,6,3,0,3,3,0,0,9,15
2340,68052529,2680500,2680550,1252900,1252950,3,3,3,3,3,0,15,4,3,4,3,3,0,17,32
2341,68052526,2680500,2680550,1252600,1252650,0,3,3,0,0,0,6,3,3,0,0,3,0,9,15
2342,68062479,2680600,2680650,1247900,1247950,3,0,3,0,0,0,6,0,3,0,3,0,0,6,12
2343,68062462,2680600,2680650,1246200,1246250,3,4,3,3,3,3,19,3,3,3,3,3,3,18,37
2344,68062523,2680600,2680650,1252300,1252350,3,3,0,3,0,0,9,3,0,3,3,3,0,12,21
2345,68072458,2680700,2680750,1245800,1245850,0,3,3,0,0,0,6,3,0,3,0,0,0,6,12
2346,68072497,2680700,2680750,1249700,1249750,0,0,0,3,0,0,3,0,0,0,0,3,0,3,6
2347,68072527,2680700,2680750,1252700,1252750,3,0,0,3,3,0,9,3,0,3,3,0,3,12,21
2348,68072499,2680700,2680750,1249900,1249950,3,3,3,3,0,0,12,3,3,3,0,0,0,9,21
2349,68082480,2680800,2680850,1248000,1248050,0,3,0,3,0,3,9,3,3,3,3,3,3,18,27
2350,68082499,2680800,2680850,1249900,1249950,3,3,3,3,0,0,12,4,5,3,3,3,0,18,30
2351,68082503,2680800,2680850,1250300,1250350,5,3,3,3,3,0,17,3,3,3,3,0,3,15,32
2352,68082452,2680800,2680850,1245200,1245250,3,0,3,3,3,3,15,3,3,3,3,3,0,15,30
2353,68092465,2680900,2680950,1246500,1246550,3,4,6,3,6,12,34,3,3,11,8,19,36,80,114
2354,68092454,2680900,2680950,1245400,1245450,5,3,4,3,0,0,15,4,3,0,3,3,0,13,28
2355,68092494,2680900,2680950,1249400,1249450,5,0,3,0,0,0,8,3,0,0,3,0,0,6,14
2356,68092474,2680900,2680950,1247400,1247450,3,3,3,0,0,0,9,3,0,3,0,0,0,6,15
2357,68092522,2680900,2680950,1252200,1252250,3,3,6,3,0,3,18,7,6,8,3,0,0,24,42
2358,68092518,2680900,2680950,1251800,1251850,3,0,3,0,0,0,6,3,0,3,0,0,0,6,12
2359,68102456,2681000,2681050,1245600,1245650,0,3,4,3,0,0,10,3,6,3,3,0,0,15,25
2360,68102472,2681000,2681050,1247200,1247250,5,6,4,3,3,3,24,6,9,3,3,3,3,27,51
2361,68102478,2681000,2681050,1247800,1247850,0,0,0,0,0,0,0,0,0,0,0,0,0,0,0
2362,68102532,2681000,2681050,1253200,1253250,3,5,3,3,0,0,14,3,4,0,3,3,0,13,27
2363,68102521,2681000,2681050,1252100,1252150,0,0,3,0,3,0,6,3,0,3,3,3,3,15,21
2364,68102502,2681000,2681050,1250200,1250250,3,0,3,3,0,0,9,3,5,0,5,3,0,16,25
2365,68102426,2681000,2681050,1242600,1242650,0,0,0,0,0,0,0,0,0,0,0,0,0,0,0
2366,68112460,2681100,2681150,1246000,1246050,5,3,0,0,0,3,11,6,3,3,3,3,0,18,29
2367,68112502,2681100,2681150,1250200,1250250,3,3,0,0,0,0,6,0,0,0,3,0,3,6,12
2368,68122522,2681200,2681250,1252200,1252250,3,3,0,3,3,3,15,4,3,0,3,0,0,10,25
2369,68122490,2681200,2681250,1249000,1249050,3,0,0,0,0,0,3,0,0,3,3,0,0,6,9
2370,68122461,2681200,2681250,1246100,1246150,3,3,0,0,3,0,9,3,0,0,0,0,0,3,12
2371,68122457,2681200,2681250,1245700,1245750,0,0,0,0,0,3,3,0,0,0,0,0,0,0,3
2372,68132461,2681300,2681350,1246100,1246150,3,3,3,0,0,0,9,3,3,3,0,3,3,15,24
2373,68132465,2681300,2681350,1246500,1246550,4,0,3,0,0,3,10,0,0,3,3,0,0,6,16
2374,68142467,2681400,2681450,1246700,1246750,3,3,3,0,0,0,9,5,4,3,0,0,3,15,24
2375,68142501,2681400,2681450,1250100,1250150,0,3,3,3,0,0,9,3,3,3,0,3,3,15,24
2376,68142428,2681400,2681450,1242800,1242850,0,0,0,0,0,0,0,0,3,0,0,0,0,3,3
2377,68142483,2681400,2681450,1248300,1248350,6,3,3,3,0,0,15,5,3,3,3,3,0,17,32
2378,68142469,2681400,2681450,1246900,1246950,0,0,0,0,0,0,0,0,0,0,0,3,0,3,3
2379,68142462,2681400,2681450,1246200,1246250,0,3,0,0,0,0,3,3,0,0,3,0,0,6,9
2380,68152500,2681500,2681550,1250000,1250050,3,3,6,4,6,5,27,3,0,5,12,24,28,72,99
2381,68152461,2681500,2681550,1246100,1246150,0,3,0,0,0,0,3,0,3,0,0,0,0,3,6
2382,68152477,2681500,2681550,1247700,1247750,8,7,6,3,3,3,30,10,7,5,6,7,3,38,68
2383,68152475,2681500,2681550,1247500,1247550,5,3,0,0,0,0,8,7,3,3,0,0,0,13,21
2384,68152464,2681500,2681550,1246400,1246450,0,0,3,0,3,0,6,0,3,3,0,3,0,9,15
2385,68162497,2681600,2681650,1249700,1249750,4,3,3,0,0,0,10,3,3,3,0,0,3,12,22
2386,68162471,2681600,2681650,1247100,1247150,3,4,3,3,0,0,13,3,3,3,3,0,3,15,28
2387,68162469,2681600,2681650,1246900,1246950,0,0,0,3,3,3,9,0,0,3,0,3,0,6,15
2388,68162464,2681600,2681650,1246400,1246450,0,0,3,0,0,3,6,3,0,0,3,3,3,12,18
2389,68172465,2681700,2681750,1246500,1246550,4,3,0,3,0,0,10,3,3,3,3,0,0,12,22
2390,68172480,2681700,2681750,1248000,1248050,3,3,0,0,0,0,6,3,0,0,0,0,0,3,9
2391,68172481,2681700,2681750,1248100,1248150,3,3,3,0,3,0,12,4,3,3,3,3,0,16,28
2392,68172458,2681700,2681750,1245800,1245850,0,3,0,0,0,0,3,0,0,0,0,0,0,0,3
2393,68172475,2681700,2681750,1247500,1247550,3,3,0,3,0,0,9,3,3,0,0,0,0,6,15
2394,68172496,2681700,2681750,1249600,1249650,0,0,0,0,0,0,0,0,0,0,0,0,0,0,0
2395,68182475,2681800,2681850,1247500,1247550,3,3,3,3,0,0,12,0,0,3,0,0,0,3,15
2396,68182464,2681800,2681850,1246400,1246450,3,5,3,3,0,0,14,6,3,3,3,3,0,18,32
2397,68182515,2681800,2681850,1251500,1251550,4,3,3,3,3,0,16,4,3,3,0,3,0,13,29
2398,68182517,2681800,2681850,1251700,1251750,3,0,0,0,0,0,3,0,0,0,0,0,0,0,3
2399,68192517,2681900,2681950,1251700,1251750,7,3,3,3,0,0,16,3,3,0,0,0,0,6,22
2400,68192498,2681900,2681950,1249800,1249850,3,0,3,3,0,0,9,0,3,3,3,0,0,9,18
2401,68192514,2681900,2681950,1251400,1251450,0,3,3,3,0,0,9,3,3,3,0,0,0,9,18
2402,68192531,2681900,2681950,1253100,1253150,0,0,3,0,0,0,3,3,0,0,0,0,3,6,9
2403,68192447,2681900,2681950,1244700,1244750,0,0,0,0,0,0,0,0,0,0,3,0,0,3,3
2404,68202521,2682000,2682050,1252100,1252150,3,0,3,0,0,0,6,3,3,3,0,0,3,12,18
2405,68202486,2682000,2682050,1248600,1248650,3,3,3,0,0,0,9,3,3,3,0,0,0,9,18
2406,68202455,2682000,2682050,1245500,1245550,0,0,0,0,0,0,0,0,0,0,0,0,0,0,0
2407,68202454,2682000,2682050,1245400,1245450,0,0,0,0,0,0,0,0,0,0,0,0,0,0,0
2408,68212487,2682100,2682150,1248700,1248750,3,4,3,3,3,3,19,7,4,3,0,0,3,17,36
2409,68212521,2682100,2682150,1252100,1252150,3,0,3,0,0,3,9,3,3,3,0,3,3,15,24
2410,68212480,2682100,2682150,1248000,1248050,3,3,0,0,0,0,6,0,3,0,0,0,0,3,9
2411,68212457,2682100,2682150,1245700,1245750,3,5,3,3,0,0,14,4,3,3,3,3,0,16,30
2412,68222452,2682200,2682250,1245200,1245250,4,3,0,3,3,0,13,0,3,3,3,3,3,15,28
2413,68222461,2682200,2682250,1246100,1246150,3,0,3,0,0,3,9,3,3,0,3,3,3,15,24
2414,68222518,2682200,2682250,1251800,1251850,4,0,3,3,0,0,10,3,3,3,0,3,3,15,25
2415,68222474,2682200,2682250,1247400,1247450,0,3,3,0,3,3,12,4,4,6,3,5,4,26,38
2416,68222457,2682200,2682250,1245700,1245750,3,4,3,0,0,0,10,3,6,3,3,3,3,21,31
2417,68222466,2682200,2682250,1246600,1246650,0,3,0,0,3,0,6,0,3,0,3,0,0,6,12
2418,68222468,2682200,2682250,1246800,1246850,0,3,0,3,0,0,6,0,0,3,0,0,0,3,9
2419,68232462,2682300,2682350,1246200,1246250,0,0,0,0,0,0,0,0,0,0,0,0,0,0,0
2420,68232469,2682300,2682350,1246900,1246950,3,0,0,0,0,0,3,3,0,0,0,0,0,3,6
2421,68232431,2682300,2682350,1243100,1243150,3,3,0,0,0,3,9,0,3,0,3,0,0,6,15
2422,68242433,2682400,2682450,1243300,1243350,3,0,3,3,3,0,12,3,3,4,3,3,3,19,31
2423,68242484,2682400,2682450,1248400,1248450,3,4,3,0,0,0,10,5,0,3,0,0,0,8,18
2424,68242451,2682400,2682450,1245100,1245150,3,3,0,3,0,0,9,0,3,3,0,0,0,6,15
2425,68242482,2682400,2682450,1248200,1248250,0,0,0,3,3,0,6,3,0,0,4,0,0,7,13
2426,68242507,2682400,2682450,1250700,1250750,0,0,0,0,0,0,0,0,0,0,0,0,0,0,0
2427,68242471,2682400,2682450,1247100,1247150,3,0,0,0,0,0,3,0,0,0,3,0,0,3,6
2428,68252450,2682500,2682550,1245000,1245050,3,0,3,3,0,3,12,4,4,4,3,0,0,15,27
2429,68252511,2682500,2682550,1251100,1251150,3,3,0,3,0,0,9,3,3,3,3,0,0,12,21
2430,68252432,2682500,2682550,1243200,1243250,3,3,3,0,3,0,12,3,3,3,3,3,3,18,30
2431,68252518,2682500,2682550,1251800,1251850,3,3,3,3,3,0,15,4,3,0,3,3,0,13,28
2432,68252480,2682500,2682550,1248000,1248050,0,0,0,0,0,0,0,0,0,0,0,0,0,0,0
2433,68252449,2682500,2682550,1244900,1244950,3,0,3,3,0,0,9,3,3,3,0,0,0,9,18
2434,68252504,2682500,2682550,1250400,1250450,0,0,0,0,0,0,0,0,0,0,0,0,0,0,0
2435,68262436,2682600,2682650,1243600,1243650,0,0,3,3,0,13,19,3,3,5,4,22,29,66,85
2436,68262506,2682600,2682650,1250600,1250650,3,3,3,3,0,0,12,7,4,3,0,0,0,14,26
2437,68262484,2682600,2682650,1248400,1248450,4,0,3,0,0,0,7,3,3,3,3,3,0,15,22
2438,68262466,2682600,2682650,1246600,1246650,3,0,0,0,0,3,6,0,3,3,0,0,0,6,12
2439,68262490,2682600,2682650,1249000,1249050,0,3,0,0,0,0,3,3,3,0,0,0,0,6,9
2440,68272497,2682700,2682750,1249700,1249750,3,3,3,3,3,0,15,3,3,4,3,3,0,16,31
2441,68272461,2682700,2682750,1246100,1246150,0,0,3,3,0,0,6,0,3,3,0,0,0,6,12
2442,68272510,2682700,2682750,1251000,1251050,3,3,0,0,0,0,6,3,3,3,3,3,0,15,21
2443,68272428,2682700,2682750,1242800,1242850,6,4,5,3,3,3,24,4,6,9,4,9,4,36,60
2444,68272531,2682700,2682750,1253100,1253150,3,0,0,3,0,0,6,3,3,0,0,0,0,6,12
2445,68272430,2682700,2682750,1243000,1243050,3,3,3,0,0,0,9,3,3,3,0,0,3,12,21
2446,68282496,2682800,2682850,1249600,1249650,0,0,0,3,3,0,6,0,3,3,3,0,0,9,15
2447,68282499,2682800,2682850,1249900,1249950,0,3,3,3,3,3,15,0,3,0,6,3,3,15,30
2448,68282441,2682800,2682850,1244100,1244150,0,0,3,3,0,0,6,0,3,3,3,3,0,12,18
2449,68282468,2682800,2682850,1246800,1246850,3,3,0,0,0,0,6,0,3,0,3,0,0,6,12
2450,68282530,2682800,2682850,1253000,1253050,3,3,3,3,0,0,12,4,3,5,0,3,3,18,30
2451,68292510,2682900,2682950,1251000,1251050,3,3,0,0,3,0,9,3,5,3,3,3,3,20,29
2452,68292514,2682900,2682950,1251400,1251450,0,0,0,0,0,0,0,0,0,0,0,0,0,0,0
2453,68302506,2683000,2683050,1250600,1250650,3,3,0,3,3,0,12,4,3,3,0,3,0,13,25
2454,68302512,2683000,2683050,1251200,1251250,5,3,0,3,3,0,14,4,3,3,3,3,3,19,33
2455,68302491,2683000,2683050,1249100,1249150,4,3,0,5,0,0,12,5,3,5,3,0,0,16,28
2456,68302535,2683000,2683050,1253500,1253550,3,3,0,3,3,0,12,3,3,3,0,3,0,12,24
2457,68302514,2683000,2683050,1251400,1251450,3,5,3,0,0,3,14,4,3,3,3,3,3,19,33
2458,68302492,2683000,2683050,1249200,1249250,3,3,3,3,0,0,12,5,3,5,0,3,0,16,28
2459,68302508,2683000,2683050,1250800,1250850,3,0,3,0,0,0,6,3,3,3,0,3,3,15,21
2460,68312495,2683100,2683150,1249500,1249550,0,3,3,3,0,0,9,3,3,3,3,0,0,12,21
2461,68312487,2683100,2683150,1248700,1248750,3,3,0,0,0,0,6,3,3,3,3,0,3,15,21
2462,68312434,2683100,2683150,1243400,1243450,0,3,0,3,0,0,6,3,0,3,3,0,0,9,15
2463,68312489,2683100,2683150,1248900,1248950,3,3,0,0,0,0,6,3,3,3,0,0,0,9,15
2464,68312436,2683100,2683150,1243600,1243650,0,0,0,0,0,0,0,0,0,0,3,0,0,3,3
2465,68322470,2683200,2683250,1247000,1247050,0,0,0,0,0,3,3,0,0,3,3,0,0,6,9
2466,68322494,2683200,2683250,1249400,1249450,0,0,3,0,3,3,9,3,3,3,0,3,0,12,21
2467,68322532,2683200,2683250,1253200,1253250,3,3,0,0,0,0,6,0,0,3,0,0,0,3,9
2468,68322512,2683200,2683250,1251200,1251250,3,0,3,0,0,0,6,0,0,3,0,0,0,3,9
2469,68332521,2683300,2683350,1252100,1252150,3,0,3,3,0,0,9,0,3,3,3,3,0,12,21
2470,68332485,2683300,2683350,1248500,1248550,3,0,3,0,0,0,6,0,3,0,3,0,0,6,12
2471,68332536,2683300,2683350,1253600,1253650,3,3,0,3,3,0,12,4,3,3,0,3,0,13,25
2472,68342476,2683400,2683450,1247600,1247650,0,3,4,0,3,0,10,3,4,3,3,0,0,13,23
2473,68352511,2683500,2683550,1251100,1251150,0,0,3,0,3,0,6,3,3,3,0,0,0,9,15
2474,68352524,2683500,2683550,1252400,1252450,3,0,3,3,0,0,9,3,3,3,3,0,0,12,21
2475,68352522,2683500,2683550,1252200,1252250,3,0,0,3,0,0,6,3,0,3,0,0,0,6,12
2476,68352530,2683500,2683550,1253000,1253050,3,3,3,3,0,0,12,7,4,3,0,0,0,14,26
2477,68352527,2683500,2683550,1252700,1252750,3,0,3,3,0,0,9,3,0,0,0,0,3,6,15
2478,68352533,2683500,2683550,1253300,1253350,7,3,3,4,3,0,20,3,3,3,3,3,0,15,35
2479,68362469,2683600,2683650,1246900,1246950,3,3,3,3,0,0,12,3,4,0,3,0,0,10,22
2480,68362487,2683600,2683650,1248700,1248750,3,0,3,0,3,0,9,0,0,3,3,0,0,6,15
2481,68362475,2683600,2683650,1247500,1247550,4,0,7,3,3,3,20,7,4,9,4,3,0,27,47
2482,68362482,2683600,2683650,1248200,1248250,4,3,3,3,0,0,13,5,6,3,3,0,0,17,30
2483,68362484,2683600,2683650,1248400,1248450,5,5,3,3,3,3,22,6,3,3,5,4,3,24,46
2484,68372508,2683700,2683750,1250800,1250850,3,3,3,0,0,0,9,3,3,3,0,0,0,9,18
2485,68372520,2683700,2683750,1252000,1252050,3,0,0,3,0,0,6,0,0,3,3,3,0,9,15
2486,68372472,2683700,2683750,1247200,1247250,0,0,0,0,0,0,0,0,0,0,0,0,0,0,0
2487,68382524,2683800,2683850,1252400,1252450,3,3,3,3,0,0,12,0,3,5,0,3,0,11,23
2488,68382525,2683800,2683850,1252500,1252550,0,0,0,0,0,0,0,0,0,0,3,0,0,3,3
2489,68392513,2683900,2683950,1251300,1251350,3,4,3,3,0,0,13,3,3,3,0,0,0,9,22
2490,68392509,2683900,2683950,1250900,1250950,4,3,3,3,3,4,20,3,4,5,5,8,10,35,55
2491,68392460,2683900,2683950,1246000,1246050,3,3,0,3,0,0,9,0,0,4,0,0,3,7,16
2492,68402528,2684000,2684050,1252800,1252850,3,0,3,0,0,0,6,3,3,3,0,0,0,9,15
2493,68402469,2684000,2684050,1246900,1246950,3,3,0,3,0,0,9,4,3,3,0,0,0,10,19
2494,68402489,2684000,2684050,1248900,1248950,3,3,3,3,0,0,12,3,3,3,3,0,3,15,27
2495,68412527,2684100,2684150,1252700,1252750,3,3,0,0,0,0,6,3,3,0,0,0,0,6,12
2496,68422481,2684200,2684250,1248100,1248150,3,3,0,3,3,0,12,3,3,3,3,0,0,12,24
2497,68422483,2684200,2684250,1248300,1248350,3,4,3,3,0,0,13,3,5,3,4,3,3,21,34
2498,68422468,2684200,2684250,1246800,1246850,5,3,3,3,0,0,14,3,3,0,3,3,0,12,26
2499,68422453,2684200,2684250,1245300,1245350,0,0,0,0,0,0,0,0,0,0,3,0,0,3,3
2500,68432520,2684300,2684350,1252000,1252050,0,0,0,0,0,0,0,3,0,0,0,0,0,3,3
2501,68432471,2684300,2684350,1247100,1247150,3,4,3,0,3,0,13,3,3,4,3,0,3,16,29
2502,68432511,2684300,2684350,1251100,1251150,3,3,0,3,0,0,9,4,0,0,0,0,3,7,16
2503,68452513,2684500,2684550,1251300,1251350,3,3,0,3,3,0,12,3,3,3,0,0,0,9,21
2504,68452473,2684500,2684550,1247300,1247350,3,0,3,0,0,0,6,3,3,3,3,0,0,12,18
2505,68452469,2684500,2684550,1246900,1246950,3,0,4,3,6,3,19,3,3,5,16,18,11,56,75
2506,68452476,2684500,2684550,1247600,1247650,3,3,3,3,0,0,12,3,3,3,3,0,3,15,27
2507,68452466,2684500,2684550,1246600,1246650,3,3,3,3,3,3,18,3,3,3,3,0,3,15,33
2508,68452452,2684500,2684550,1245200,1245250,3,0,0,3,0,3,9,3,3,0,3,3,0,12,21
2509,68462465,2684600,2684650,1246500,1246550,3,5,3,4,3,0,18,3,4,3,5,0,3,18,36
2510,68462452,2684600,2684650,1245200,1245250,3,0,3,3,0,0,9,0,0,3,3,0,3,9,18
2511,68462482,2684600,2684650,1248200,1248250,0,3,3,0,0,0,6,3,0,3,0,0,0,6,12
2512,68462468,2684600,2684650,1246800,1246850,5,0,3,3,3,0,14,3,3,3,3,0,0,12,26
2513,68462486,2684600,2684650,1248600,1248650,0,3,3,0,0,0,6,3,3,3,3,0,0,12,18
2514,68472472,2684700,2684750,1247200,1247250,3,3,0,3,0,0,9,4,5,3,3,3,3,21,30
2515,68472476,2684700,2684750,1247600,1247650,0,0,3,0,3,0,6,3,3,3,3,3,3,18,24
2516,68472521,2684700,2684750,1252100,1252150,3,0,3,3,0,0,9,5,3,3,3,0,0,14,23
2517,68482452,2684800,2684850,1245200,1245250,0,0,0,0,0,0,0,0,0,0,0,0,0,0,0
2518,68482509,2684800,2684850,1250900,1250950,0,0,0,0,0,0,0,0,0,0,0,0,0,0,0
2519,68492472,2684900,2684950,1247200,1247250,3,3,3,3,0,0,12,3,3,3,0,0,3,12,24
2520,68492481,2684900,2684950,1248100,1248150,3,0,0,3,0,0,6,0,3,0,0,0,3,6,12
2521,68492482,2684900,2684950,1248200,1248250,3,0,4,0,0,0,7,3,3,3,3,0,0,12,19
2522,68492459,2684900,2684950,1245900,1245950,0,0,0,0,0,0,0,0,0,0,0,0,0,0,0
2523,68502482,2685000,2685050,1248200,1248250,0,3,3,3,0,0,9,0,3,3,0,3,0,9,18
2524,68512515,2685100,2685150,1251500,1251550,3,3,3,0,3,0,12,3,3,3,3,3,0,15,27
2525,68512450,2685100,2685150,1245000,1245050,3,3,3,3,0,3,15,4,3,3,3,3,3,19,34
2526,68512462,2685100,2685150,1246200,1246250,3,3,0,3,0,3,12,4,3,0,0,3,0,10,22
2527,68512482,2685100,2685150,1248200,1248250,0,3,3,0,0,3,9,3,3,3,3,3,3,18,27
2528,68522470,2685200,2685250,1247000,1247050,3,3,3,3,0,0,12,3,3,3,3,0,0,12,24
2529,68522522,2685200,2685250,1252200,1252250,3,3,3,0,0,0,9,3,0,3,3,0,0,9,18
2530,68532463,2685300,2685350,1246300,1246350,3,4,3,0,3,3,16,3,3,3,3,0,0,12,28
2531,68532462,2685300,2685350,1246200,1246250,4,3,3,3,0,0,13,3,3,3,3,0,0,12,25
2532,68532522,2685300,2685350,1252200,1252250,3,0,0,3,3,0,9,0,0,3,0,3,0,6,15
2533,68532523,2685300,2685350,1252300,1252350,3,0,0,0,3,0,6,3,3,0,3,0,0,9,15
2534,68532483,2685300,2685350,1248300,1248350,0,3,3,0,0,0,6,0,3,0,0,0,0,3,9
2535,68542479,2685400,2685450,1247900,1247950,0,3,0,0,0,0,3,3,3,0,3,0,0,9,12
2536,68542508,2685400,2685450,1250800,1250850,3,0,0,0,3,0,6,3,0,0,0,0,0,3,9
2537,68542451,2685400,2685450,1245100,1245150,3,0,0,0,3,0,6,0,0,3,3,3,0,9,15
2538,68552511,2685500,2685550,1251100,1251150,3,3,3,3,3,0,15,3,3,3,5,5,3,22,37
2539,68552508,2685500,2685550,1250800,1250850,5,3,5,5,3,3,24,5,7,5,7,5,4,33,57
2540,68552447,2685500,2685550,1244700,1244750,0,0,0,0,0,0,0,0,0,0,0,0,0,0,0
2541,68552516,2685500,2685550,1251600,1251650,0,3,3,0,0,0,6,0,0,3,0,0,0,3,9
2542,68562461,2685600,2685650,1246100,1246150,3,3,3,3,0,3,15,0,3,4,0,3,0,10,25
2543,68572457,2685700,2685750,1245700,1245750,3,3,0,0,0,0,6,3,3,3,0,0,0,9,15
2544,68572511,2685700,2685750,1251100,1251150,3,3,3,3,3,0,15,8,3,4,3,3,3,24,39
2545,68582456,2685800,2685850,1245600,1245650,0,0,0,0,0,0,0,0,0,0,0,0,0,0,0
2546,68582510,2685800,2685850,1251000,1251050,3,6,3,3,3,0,18,6,4,3,0,3,0,16,34
2547,68582451,2685800,2685850,1245100,1245150,6,0,3,0,0,0,9,3,3,0,0,0,0,6,15
2548,68592488,2685900,2685950,1248800,1248850,3,3,0,3,3,3,15,3,3,0,3,3,3,15,30
2549,68592513,2685900,2685950,1251300,1251350,3,3,3,3,0,0,12,3,3,3,3,0,0,12,24
2550,68602510,2686000,2686050,1251000,1251050,3,4,4,3,3,0,17,4,4,4,3,3,3,21,38
2551,68602511,2686000,2686050,1251100,1251150,3,6,3,4,0,3,19,3,4,3,3,3,3,19,38
2552,68602516,2686000,2686050,1251600,1251650,3,3,0,0,0,0,6,3,0,0,3,0,0,6,12
2553,68622514,2686200,2686250,1251400,1251450,4,3,3,0,3,0,13,3,7,3,3,3,0,19,32
2554,68642460,2686400,2686450,1246000,1246050,3,0,3,0,0,3,9,3,3,3,0,3,0,12,21
2555,68642509,2686400,2686450,1250900,1250950,0,0,0,3,0,0,3,3,3,3,0,0,0,9,12
2556,68652460,2686500,2686550,1246000,1246050,3,3,3,3,3,3,18,4,3,5,3,4,3,22,40
2557,68672508,2686700,2686750,1250800,1250850,3,0,0,3,0,3,9,3,3,0,0,4,3,13,22
2558,68672462,2686700,2686750,1246200,1246250,3,0,3,3,3,3,15,0,3,7,0,3,3,16,31
2559,68702461,2687000,2687050,1246100,1246150,4,3,5,8,3,0,23,3,7,9,4,3,3,29,52
2560,68702504,2687000,2687050,1250400,1250450,3,4,3,3,0,0,13,3,3,4,0,0,3,13,26
2561,68702458,2687000,2687050,1245800,1245850,3,3,3,0,0,0,9,3,3,3,0,0,0,9,18
2562,68722456,2687200,2687250,1245600,1245650,3,0,0,3,3,0,9,3,0,3,0,0,0,6,15
2563,68722464,2687200,2687250,1246400,1246450,0,3,0,0,0,0,3,3,3,3,0,0,0,9,12
2564,68752455,2687500,2687550,1245500,1245550,3,5,7,5,3,3,26,3,5,8,3,3,3,25,51
2565,68772460,2687700,2687750,1246000,1246050,3,3,0,0,3,0,9,3,3,3,3,3,3,18,27
2566,68782462,2687800,2687850,1246200,1246250,3,3,3,3,0,0,12,3,0,3,3,0,0,9,21
2567,68782453,2687800,2687850,1245300,1245350,3,3,3,3,3,0,15,0,3,3,3,3,0,12,27
2568,68792463,2687900,2687950,1246300,1246350,0,0,0,0,0,0,0,0,0,0,0,0,0,0,0
2569,68802455,2688000,2688050,1245500,1245550,3,3,4,0,0,0,10,3,6,3,3,3,0,18,28
2570,67762492,2677600,2677650,1249200,1249250,4,3,3,3,3,0,16,3,3,5,5,4,3,23,39
2571,67812488,2678100,2678150,1248800,1248850,0,3,3,0,0,0,6,0,3,3,3,3,0,12,18
2572,67822486,2678200,2678250,1248600,1248650,0,3,0,3,3,0,9,0,0,0,0,3,0,3,12
2573,67832519,2678300,2678350,1251900,1251950,0,0,0,0,3,0,3,3,0,3,3,3,3,15,18
2574,67832489,2678300,2678350,1248900,1248950,5,3,3,3,3,0,17,3,3,3,3,3,3,18,35
2575,67852491,2678500,2678550,1249100,1249150,4,3,3,3,0,0,13,3,3,0,0,3,0,9,22
2576,67852479,2678500,2678550,1247900,1247950,0,0,3,0,0,0,3,3,0,0,0,0,0,3,6
2577,67862487,2678600,2678650,1248700,1248750,5,3,3,3,3,0,17,7,3,3,3,3,3,22,39
2578,67862495,2678600,2678650,1249500,1249550,3,3,3,0,3,3,15,3,0,3,0,3,0,9,24
2579,67862477,2678600,2678650,1247700,1247750,3,3,0,3,0,0,9,3,3,3,0,3,0,12,21
2580,67862508,2678600,2678650,1250800,1250850,0,0,0,0,0,0,0,3,0,0,0,0,0,3,3
2581,67872486,2678700,2678750,1248600,1248650,9,13,5,7,3,0,37,7,11,5,5,6,3,37,74
2582,67872492,2678700,2678750,1249200,1249250,4,3,3,3,3,0,16,3,3,3,3,3,3,18,34
2583,67872511,2678700,2678750,1251100,1251150,3,0,3,3,0,0,9,3,3,3,3,3,3,18,27
2584,67872500,2678700,2678750,1250000,1250050,3,0,3,0,0,0,6,3,0,0,0,0,0,3,9
2585,67882508,2678800,2678850,1250800,1250850,3,0,3,7,3,6,22,0,3,8,10,20,39,80,102
2586,67892474,2678900,2678950,1247400,1247450,3,3,3,3,0,0,12,3,3,3,0,0,0,9,21
2587,67902509,2679000,2679050,1250900,1250950,3,0,0,0,0,0,3,3,3,0,0,0,0,6,9
2588,67902482,2679000,2679050,1248200,1248250,3,0,0,0,3,3,9,0,3,0,0,3,0,6,15
2589,67912510,2679100,2679150,1251000,1251050,3,3,3,3,3,0,15,3,3,3,3,3,3,18,33
2590,67912509,2679100,2679150,1250900,1250950,3,3,0,3,0,0,9,3,3,3,3,3,3,18,27
2591,67912477,2679100,2679150,1247700,1247750,3,3,3,3,0,3,15,3,3,4,3,3,3,19,34
2592,67922487,2679200,2679250,1248700,1248750,4,3,3,0,0,0,10,5,3,3,0,3,3,17,27
2593,67922498,2679200,2679250,1249800,1249850,3,3,0,0,0,0,6,3,3,0,3,3,0,12,18
2594,67922469,2679200,2679250,1246900,1246950,0,3,0,0,0,0,3,3,0,0,0,0,3,6,9
2595,67922467,2679200,2679250,1246700,1246750,0,0,0,0,0,0,0,3,0,0,0,0,0,3,3
2596,67922478,2679200,2679250,1247800,1247850,3,9,9,5,8,3,37,10,11,13,13,3,3,53,90
2597,67922513,2679200,2679250,1251300,1251350,0,0,0,0,0,0,0,0,0,0,3,0,0,3,3
2598,67932513,2679300,2679350,1251300,1251350,3,3,3,3,0,0,12,0,4,3,3,3,3,16,28
2599,67932469,2679300,2679350,1246900,1246950,3,0,3,0,0,0,6,3,0,0,0,3,0,6,12
2600,67932492,2679300,2679350,1249200,1249250,5,7,3,0,0,0,15,4,7,0,3,3,0,17,32
2601,67932470,2679300,2679350,1247000,1247050,0,3,0,3,0,0,6,3,3,3,3,0,3,15,21
2602,67932468,2679300,2679350,1246800,1246850,3,0,0,0,0,0,3,3,0,3,0,0,0,6,9
2603,67932506,2679300,2679350,1250600,1250650,0,3,3,0,3,0,9,0,3,0,3,0,0,6,15
2604,67932477,2679300,2679350,1247700,1247750,4,3,3,0,0,0,10,3,3,3,3,0,0,12,22
2605,67932483,2679300,2679350,1248300,1248350,3,3,0,3,0,0,9,3,3,3,0,0,0,9,18
2606,67942470,2679400,2679450,1247000,1247050,3,5,0,4,0,4,16,3,5,3,3,0,3,17,33
2607,67942472,2679400,2679450,1247200,1247250,3,3,3,3,3,3,18,3,4,3,3,3,0,16,34
2608,67952506,2679500,2679550,1250600,1250650,3,0,3,3,0,0,9,3,0,3,4,3,0,13,22
2609,67952467,2679500,2679550,1246700,1246750,3,3,0,0,0,0,6,3,0,0,0,3,0,6,12
2610,67952476,2679500,2679550,1247600,1247650,3,3,3,0,0,3,12,7,5,3,3,3,0,21,33
2611,67952499,2679500,2679550,1249900,1249950,0,3,3,3,0,0,9,3,0,3,3,0,0,9,18
2612,67962484,2679600,2679650,1248400,1248450,0,0,0,0,0,0,0,0,0,0,0,0,0,0,0
2613,67972511,2679700,2679750,1251100,1251150,0,3,3,4,3,0,13,3,3,3,6,3,3,21,34
2614,67972473,2679700,2679750,1247300,1247350,3,3,0,0,3,0,9,4,3,3,3,3,3,19,28
2615,67972465,2679700,2679750,1246500,1246550,0,0,3,0,0,0,3,0,0,3,0,0,0,3,6
2616,67972491,2679700,2679750,1249100,1249150,0,3,0,0,0,0,3,3,0,0,0,0,0,3,6
2617,67972502,2679700,2679750,1250200,1250250,0,0,0,0,3,0,3,3,3,3,3,0,0,12,15
2618,67992479,2679900,2679950,1247900,1247950,3,3,3,0,0,3,12,3,3,3,3,3,0,15,27
2619,67992531,2679900,2679950,1253100,1253150,5,6,3,0,3,0,17,10,3,3,3,0,0,19,36
2620,67992486,2679900,2679950,1248600,1248650,0,0,0,0,0,3,3,3,0,0,3,0,0,6,9
2621,68002469,2680000,2680050,1246900,1246950,3,0,3,0,0,3,9,3,0,0,3,3,0,9,18
2622,68002482,2680000,2680050,1248200,1248250,0,3,0,0,0,0,3,3,3,3,0,0,0,9,12
2623,68012488,2680100,2680150,1248800,1248850,3,4,3,3,0,0,13,4,3,3,3,3,0,16,29
2624,68012472,2680100,2680150,1247200,1247250,3,7,3,8,5,3,29,3,4,7,15,5,3,37,66
2625,68022505,2680200,2680250,1250500,1250550,3,3,0,0,0,0,6,3,3,3,3,0,0,12,18
2626,68022527,2680200,2680250,1252700,1252750,0,3,3,3,0,0,9,0,3,0,3,0,0,6,15
2627,68022485,2680200,2680250,1248500,1248550,4,0,0,3,3,0,10,3,3,3,0,3,3,15,25
2628,68022477,2680200,2680250,1247700,1247750,5,3,3,3,3,0,17,3,7,10,4,3,3,30,47
2629,68022452,2680200,2680250,1245200,1245250,0,3,3,0,3,0,9,0,0,3,3,0,0,6,15
2630,68022461,2680200,2680250,1246100,1246150,3,3,3,3,3,3,18,4,3,3,3,0,3,16,34
2631,68032481,2680300,2680350,1248100,1248150,3,0,0,3,0,0,6,0,3,3,0,0,0,6,12
2632,68032507,2680300,2680350,1250700,1250750,3,0,4,3,3,0,13,3,3,3,3,3,0,15,28
2633,68042479,2680400,2680450,1247900,1247950,0,3,0,0,0,0,3,3,0,0,0,0,3,6,9
2634,68052460,2680500,2680550,1246000,1246050,3,0,0,3,3,0,9,0,0,0,3,0,0,3,12
2635,68052524,2680500,2680550,1252400,1252450,0,3,3,3,3,3,15,4,3,3,0,3,0,13,28
2636,68052473,2680500,2680550,1247300,1247350,3,0,0,0,0,0,3,0,0,0,0,0,0,0,3
2637,68052459,2680500,2680550,1245900,1245950,0,0,0,0,0,0,0,0,0,0,0,0,0,0,0
2638,68052503,2680500,2680550,1250300,1250350,0,3,0,3,3,0,9,0,3,3,0,3,3,12,21
2639,68052499,2680500,2680550,1249900,1249950,3,0,0,0,0,0,3,3,0,0,0,0,0,3,6
2640,68062466,2680600,2680650,1246600,1246650,3,3,0,3,0,0,9,0,3,3,3,3,0,12,21
2641,68062519,2680600,2680650,1251900,1251950,3,4,5,4,4,0,20,3,9,7,6,0,0,25,45
2642,68062472,2680600,2680650,1247200,1247250,3,3,0,0,0,0,6,0,0,0,0,0,0,0,6
2643,68072529,2680700,2680750,1252900,1252950,3,0,0,0,0,0,3,3,0,0,0,0,0,3,6
2644,68072494,2680700,2680750,1249400,1249450,0,0,0,0,0,0,0,0,0,0,3,0,0,3,3
2645,68082471,2680800,2680850,1247100,1247150,0,3,0,0,0,0,3,0,0,3,0,0,0,3,6
2646,68082519,2680800,2680850,1251900,1251950,0,3,3,0,0,3,9,0,3,3,4,3,3,16,25
2647,68082465,2680800,2680850,1246500,1246550,3,3,0,3,0,3,12,0,3,3,0,5,7,18,30
2648,68092457,2680900,2680950,1245700,1245750,3,3,0,0,0,0,6,3,0,3,0,0,0,6,12
2649,68092455,2680900,2680950,1245500,1245550,3,3,3,0,0,3,12,3,4,3,3,3,0,16,28
2650,68092419,2680900,2680950,1241900,1241950,0,0,0,0,0,0,0,0,0,0,0,0,0,0,0
2651,68092498,2680900,2680950,1249800,1249850,3,3,3,0,0,0,9,3,3,0,3,0,3,12,21
2652,68102517,2681000,2681050,1251700,1251750,0,0,0,0,0,0,0,0,0,0,0,0,0,0,0
2653,68112485,2681100,2681150,1248500,1248550,4,4,3,3,0,0,14,3,3,3,3,0,0,12,26
2654,68112469,2681100,2681150,1246900,1246950,5,3,3,3,0,0,14,3,3,3,3,3,0,15,29
2655,68112421,2681100,2681150,1242100,1242150,3,0,4,0,0,0,7,3,3,3,3,0,0,12,19
2656,68122466,2681200,2681250,1246600,1246650,3,3,3,0,3,0,12,4,3,3,3,3,0,16,28
2657,68122531,2681200,2681250,1253100,1253150,3,0,0,3,0,0,6,3,3,3,0,0,0,9,15
2658,68122420,2681200,2681250,1242000,1242050,3,5,3,3,3,0,17,4,6,6,3,0,0,19,36
2659,68132424,2681300,2681350,1242400,1242450,0,3,3,3,4,0,13,3,3,4,3,3,0,16,29
2660,68132468,2681300,2681350,1246800,1246850,3,3,0,0,0,0,6,3,3,0,0,0,0,6,12
2661,68132420,2681300,2681350,1242000,1242050,0,3,3,3,0,0,9,3,0,3,0,3,0,9,18
2662,68142482,2681400,2681450,1248200,1248250,5,3,4,0,0,0,12,7,5,3,3,4,3,25,37
2663,68142434,2681400,2681450,1243400,1243450,3,3,3,0,0,0,9,3,3,0,3,3,0,12,21
2664,68152479,2681500,2681550,1247900,1247950,3,3,3,0,0,0,9,3,0,0,0,0,0,3,12
2665,68152501,2681500,2681550,1250100,1250150,0,3,0,3,0,0,6,3,3,3,3,3,3,18,24
2666,68152482,2681500,2681550,1248200,1248250,5,3,3,3,3,0,17,8,6,3,3,3,0,23,40
2667,68152536,2681500,2681550,1253600,1253650,0,0,0,0,0,0,0,0,0,0,0,0,0,0,0
2668,68152423,2681500,2681550,1242300,1242350,3,0,0,0,3,0,6,0,3,3,0,0,0,6,12
2669,68152488,2681500,2681550,1248800,1248850,0,0,0,0,0,0,0,0,0,0,0,0,0,0,0
2670,68162499,2681600,2681650,1249900,1249950,0,0,3,0,3,0,6,0,3,3,0,3,0,9,15
2671,68162490,2681600,2681650,1249000,1249050,0,0,0,0,0,0,0,0,0,0,0,0,0,0,0
2672,68162532,2681600,2681650,1253200,1253250,3,3,3,0,0,0,9,4,3,0,3,0,0,10,19
2673,68162436,2681600,2681650,1243600,1243650,3,3,0,0,0,0,6,3,3,0,0,3,0,9,15
2674,68172472,2681700,2681750,1247200,1247250,3,3,3,0,0,0,9,0,3,3,0,0,0,6,15
2675,68172499,2681700,2681750,1249900,1249950,3,3,3,3,3,0,15,3,3,3,3,3,3,18,33
2676,68172432,2681700,2681750,1243200,1243250,3,3,0,0,0,0,6,0,0,0,0,0,0,0,6
2677,68182470,2681800,2681850,1247000,1247050,0,3,3,0,0,0,6,3,3,0,0,0,0,6,12
2678,68182436,2681800,2681850,1243600,1243650,0,0,0,0,0,0,0,0,0,0,0,0,0,0,0
2679,68182532,2681800,2681850,1253200,1253250,3,3,3,3,3,0,15,4,3,3,0,0,0,10,25
2680,68202515,2682000,2682050,1251500,1251550,3,0,3,0,3,0,9,3,3,3,3,3,0,15,24
2681,68202480,2682000,2682050,1248000,1248050,5,3,3,0,0,0,11,3,3,0,0,0,0,6,17
2682,68202518,2682000,2682050,1251800,1251850,0,0,3,0,3,3,9,0,3,4,4,3,0,14,23
2683,68202447,2682000,2682050,1244700,1244750,0,3,3,3,0,0,9,3,3,0,3,0,0,9,18
2684,68202456,2682000,2682050,1245600,1245650,0,0,0,0,0,0,0,0,0,0,0,0,0,0,0
2685,68212479,2682100,2682150,1247900,1247950,3,3,3,0,0,0,9,3,0,3,0,0,0,6,15
2686,68212512,2682100,2682150,1251200,1251250,3,3,0,0,0,0,6,3,0,3,0,0,0,6,12
2687,68212453,2682100,2682150,1245300,1245350,3,4,3,0,0,0,10,3,5,0,3,3,0,14,24
2688,68212466,2682100,2682150,1246600,1246650,0,0,0,0,0,0,0,0,0,0,0,0,0,0,0
2689,68222500,2682200,2682250,1250000,1250050,3,3,3,0,0,0,9,3,3,3,0,3,0,12,21
2690,68222456,2682200,2682250,1245600,1245650,3,4,3,3,3,0,16,3,6,3,3,0,3,18,34
2691,68222485,2682200,2682250,1248500,1248550,0,0,0,0,0,0,0,0,0,0,0,0,0,0,0
2692,68232436,2682300,2682350,1243600,1243650,3,3,3,3,3,0,15,3,3,7,3,3,3,22,37
2693,68232471,2682300,2682350,1247100,1247150,3,3,0,0,0,0,6,0,0,0,0,0,0,0,6
2694,68232477,2682300,2682350,1247700,1247750,3,3,3,3,0,0,12,4,3,0,3,3,0,13,25
2695,68232480,2682300,2682350,1248000,1248050,3,0,3,0,0,0,6,3,0,0,0,0,0,3,9
2696,68232476,2682300,2682350,1247600,1247650,0,3,0,0,0,0,3,3,3,3,0,3,3,15,18
2697,68232441,2682300,2682350,1244100,1244150,0,0,3,3,0,0,6,0,3,3,3,3,3,15,21
2698,68232443,2682300,2682350,1244300,1244350,5,3,3,3,3,0,17,5,4,5,3,3,3,23,40
2699,68232516,2682300,2682350,1251600,1251650,3,3,0,3,0,0,9,3,3,0,3,0,0,9,18
2700,68232513,2682300,2682350,1251300,1251350,0,3,3,0,0,0,6,0,0,0,0,3,3,6,12
2701,68242513,2682400,2682450,1251300,1251350,3,3,3,3,0,0,12,5,3,0,0,0,0,8,20
2702,68242523,2682400,2682450,1252300,1252350,0,3,0,0,3,0,6,4,0,0,3,3,0,10,16
2703,68242431,2682400,2682450,1243100,1243150,3,3,3,3,3,3,18,4,3,3,3,3,3,19,37
2704,68242470,2682400,2682450,1247000,1247050,3,3,3,3,0,3,15,3,3,4,3,0,0,13,28
2705,68252521,2682500,2682550,1252100,1252150,3,0,0,0,0,0,3,0,0,3,0,0,0,3,6
2706,68252470,2682500,2682550,1247000,1247050,0,3,0,3,0,0,6,3,3,3,0,0,0,9,15
2707,68252434,2682500,2682550,1243400,1243450,3,3,3,0,0,0,9,0,0,0,3,0,0,3,12
2708,68252512,2682500,2682550,1251200,1251250,3,3,6,0,0,0,12,5,4,6,3,3,0,21,33
2709,68252484,2682500,2682550,1248400,1248450,0,0,0,3,0,0,3,0,0,0,0,0,0,0,3
2710,68252491,2682500,2682550,1249100,1249150,0,3,0,0,0,0,3,0,0,0,0,0,0,0,3
2711,68262445,2682600,2682650,1244500,1244550,3,3,4,0,0,0,10,3,3,0,3,3,0,12,22
2712,68262517,2682600,2682650,1251700,1251750,5,3,0,3,0,0,11,3,3,0,0,3,0,9,20
2713,68262523,2682600,2682650,1252300,1252350,3,3,3,0,0,0,9,4,3,3,0,0,0,10,19
2714,68262448,2682600,2682650,1244800,1244850,0,3,3,0,0,0,6,0,3,3,3,0,0,9,15
2715,68262440,2682600,2682650,1244000,1244050,3,0,0,0,0,3,6,0,0,0,0,3,0,3,9
2716,68272498,2682700,2682750,1249800,1249850,3,3,4,4,3,0,17,3,3,3,3,3,0,15,32
2717,68272443,2682700,2682750,1244300,1244350,0,3,3,3,0,0,9,3,0,3,3,3,0,12,21
2718,68272462,2682700,2682750,1246200,1246250,0,3,0,0,0,0,3,3,3,0,3,0,0,9,12
2719,68272535,2682700,2682750,1253500,1253550,3,3,3,3,3,0,15,3,3,3,3,0,0,12,27
2720,68282507,2682800,2682850,1250700,1250750,4,4,3,0,0,0,11,4,3,0,4,3,0,14,25
2721,68282474,2682800,2682850,1247400,1247450,0,0,0,0,0,0,0,0,0,0,0,0,0,0,0
2722,68282535,2682800,2682850,1253500,1253550,3,3,3,0,3,3,15,3,0,3,3,0,3,12,27
2723,68282431,2682800,2682850,1243100,1243150,3,3,3,0,0,3,12,3,3,3,3,3,0,15,27
2724,68282475,2682800,2682850,1247500,1247550,0,0,0,0,0,0,0,0,0,0,0,0,0,0,0
2725,68282509,2682800,2682850,1250900,1250950,0,3,3,3,0,0,9,0,3,0,3,0,0,6,15
2726,68282464,2682800,2682850,1246400,1246450,0,0,0,3,0,0,3,0,0,0,0,0,0,0,3
2727,68282538,2682800,2682850,1253800,1253850,3,3,3,3,0,0,12,3,0,3,0,0,0,6,18
2728,68292495,2682900,2682950,1249500,1249550,4,3,3,0,0,0,10,3,3,3,3,0,3,15,25
2729,68292512,2682900,2682950,1251200,1251250,0,0,0,3,0,0,3,0,3,0,3,0,0,6,9
2730,68292488,2682900,2682950,1248800,1248850,0,0,0,3,0,0,3,0,0,3,0,0,0,3,6
2731,68302516,2683000,2683050,1251600,1251650,3,3,3,3,0,0,12,3,4,0,0,3,3,13,25
2732,68302497,2683000,2683050,1249700,1249750,3,3,0,3,0,0,9,3,3,3,0,0,0,9,18
2733,68312499,2683100,2683150,1249900,1249950,3,4,3,0,3,0,13,6,3,3,3,3,3,21,34
2734,68312518,2683100,2683150,1251800,1251850,3,0,0,3,3,0,9,3,3,3,0,0,0,9,18
2735,68322539,2683200,2683250,1253900,1253950,3,3,0,3,0,3,12,3,0,3,3,0,3,12,24
2736,68322513,2683200,2683250,1251300,1251350,0,0,0,0,0,0,0,0,0,0,0,0,0,0,0
2737,68332492,2683300,2683350,1249200,1249250,3,3,3,0,0,0,9,4,3,3,0,3,0,13,22
2738,68332522,2683300,2683350,1252200,1252250,0,0,0,0,0,0,0,0,0,0,0,0,0,0,0
2739,68332487,2683300,2683350,1248700,1248750,3,0,3,0,3,0,9,3,0,3,0,3,0,9,18
2740,68332432,2683300,2683350,1243200,1243250,3,0,0,0,3,0,6,0,0,4,3,0,0,7,13
2741,68342496,2683400,2683450,1249600,1249650,5,3,3,3,3,0,17,5,4,3,0,0,0,12,29
2742,68342497,2683400,2683450,1249700,1249750,3,3,3,0,0,0,9,7,4,4,3,3,3,24,33
2743,68342514,2683400,2683450,1251400,1251450,3,0,3,3,0,0,9,3,0,3,3,0,3,12,21
2744,68342523,2683400,2683450,1252300,1252350,3,3,0,3,0,3,12,3,3,5,3,3,3,20,32
2745,68352520,2683500,2683550,1252000,1252050,3,3,3,3,0,0,12,3,3,3,3,3,0,15,27
2746,68352478,2683500,2683550,1247800,1247850,0,0,0,0,0,0,0,0,0,0,0,0,0,0,0
2747,68352474,2683500,2683550,1247400,1247450,8,6,10,5,0,3,32,15,12,13,3,3,3,49,81
2748,68352488,2683500,2683550,1248800,1248850,3,0,4,3,0,0,10,3,3,4,0,0,3,13,23
2749,68352526,2683500,2683550,1252600,1252650,3,3,3,0,0,0,9,3,3,0,0,0,0,6,15
2750,68352469,2683500,2683550,1246900,1246950,4,3,3,0,3,0,13,3,3,3,0,0,0,9,22
2751,68362517,2683600,2683650,1251700,1251750,0,0,3,3,0,0,6,3,3,3,3,0,3,15,21
2752,68362524,2683600,2683650,1252400,1252450,3,3,3,3,3,0,15,3,3,0,5,0,3,14,29
2753,68362477,2683600,2683650,1247700,1247750,0,3,0,0,0,0,3,0,0,3,3,0,3,9,12
2754,68362486,2683600,2683650,1248600,1248650,3,3,3,3,0,0,12,4,3,3,0,0,3,13,25
2755,68372533,2683700,2683750,1253300,1253350,7,3,3,3,0,0,16,6,5,6,3,3,3,26,42
2756,68372513,2683700,2683750,1251300,1251350,3,3,0,3,0,0,9,0,3,3,3,0,0,9,18
2757,68372523,2683700,2683750,1252300,1252350,0,5,3,0,0,0,8,3,3,3,3,0,0,12,20
2758,68382462,2683800,2683850,1246200,1246250,3,3,0,0,0,0,6,3,3,3,3,0,0,12,18
2759,68392511,2683900,2683950,1251100,1251150,3,3,3,0,0,0,9,3,0,3,3,0,3,12,21
2760,68392528,2683900,2683950,1252800,1252850,3,3,0,3,0,3,12,3,4,0,3,3,3,16,28
2761,68392485,2683900,2683950,1248500,1248550,3,3,3,3,3,3,18,0,3,3,0,3,0,9,27
2762,68392474,2683900,2683950,1247400,1247450,0,0,0,0,0,0,0,0,0,0,0,0,0,0,0
2763,68392476,2683900,2683950,1247600,1247650,0,0,0,0,0,0,0,0,0,0,0,0,0,0,0
2764,68392456,2683900,2683950,1245600,1245650,3,3,0,0,0,0,6,3,0,0,0,0,0,3,9
2765,68402513,2684000,2684050,1251300,1251350,0,3,3,0,3,0,9,3,3,3,3,0,0,12,21
2766,68402487,2684000,2684050,1248700,1248750,3,3,3,3,3,0,15,5,4,3,0,3,3,18,33
2767,68412526,2684100,2684150,1252600,1252650,3,3,0,0,0,0,6,3,3,3,3,0,0,12,18
2768,68412458,2684100,2684150,1245800,1245850,3,3,4,0,0,0,10,3,10,3,3,3,3,25,35
2769,68422462,2684200,2684250,1246200,1246250,3,3,0,0,0,0,6,4,3,3,3,0,3,16,22
2770,68422472,2684200,2684250,1247200,1247250,3,3,3,3,3,0,15,3,0,0,3,3,3,12,27
2771,68422523,2684200,2684250,1252300,1252350,3,0,0,0,0,0,3,0,0,0,0,0,0,0,3
2772,68432470,2684300,2684350,1247000,1247050,3,3,3,3,0,0,12,3,3,3,3,0,3,15,27
2773,68432457,2684300,2684350,1245700,1245750,3,3,3,0,0,0,9,3,3,3,0,3,0,12,21
2774,68432509,2684300,2684350,1250900,1250950,3,0,3,3,0,0,9,0,0,4,0,0,0,4,13
2775,68432488,2684300,2684350,1248800,1248850,0,3,0,0,0,0,3,0,0,0,0,0,0,0,3
2776,68432476,2684300,2684350,1247600,1247650,3,0,0,0,0,0,3,0,0,0,0,0,0,0,3
2777,68452453,2684500,2684550,1245300,1245350,4,4,0,3,0,0,11,3,3,3,3,3,3,18,29
2778,68452525,2684500,2684550,1252500,1252550,3,0,0,0,0,0,3,0,0,0,0,0,0,0,3
2779,68452519,2684500,2684550,1251900,1251950,0,0,0,0,0,0,0,0,0,0,0,0,0,0,0
2780,68462459,2684600,2684650,1245900,1245950,0,0,0,0,0,0,0,0,3,0,0,0,0,3,3
2781,68472487,2684700,2684750,1248700,1248750,3,0,3,3,0,0,9,3,3,3,0,0,0,9,18
2782,68472512,2684700,2684750,1251200,1251250,3,3,3,3,0,0,12,3,3,3,0,3,3,15,27
2783,68472454,2684700,2684750,1245400,1245450,3,4,3,0,3,0,13,0,3,3,0,3,0,9,22
2784,68472482,2684700,2684750,1248200,1248250,0,0,3,3,3,0,9,0,3,3,0,3,0,9,18
2785,68482460,2684800,2684850,1246000,1246050,0,0,3,3,0,0,6,3,3,3,3,0,0,12,18
2786,68482514,2684800,2684850,1251400,1251450,0,0,0,0,0,0,0,0,0,0,0,0,0,0,0
2787,68482470,2684800,2684850,1247000,1247050,3,0,3,3,0,0,9,3,0,4,0,0,0,7,16
2788,68482486,2684800,2684850,1248600,1248650,3,0,0,3,0,0,6,3,3,3,3,0,0,12,18
2789,68482459,2684800,2684850,1245900,1245950,0,3,0,0,0,0,3,3,0,0,0,0,0,3,6
2790,68492519,2684900,2684950,1251900,1251950,3,3,0,0,0,0,6,4,0,0,0,0,0,4,10
2791,68492510,2684900,2684950,1251000,1251050,3,3,3,3,0,0,12,5,3,6,6,3,3,26,38
2792,68492515,2684900,2684950,1251500,1251550,0,3,0,0,0,0,3,0,0,3,0,0,0,3,6
2793,68502467,2685000,2685050,1246700,1246750,3,3,5,3,0,3,17,3,3,6,0,3,0,15,32
2794,68502479,2685000,2685050,1247900,1247950,3,3,0,3,3,0,12,5,4,3,3,3,3,21,33
2795,68512517,2685100,2685150,1251700,1251750,3,4,3,0,0,0,10,9,4,3,0,0,0,16,26
2796,68512510,2685100,2685150,1251000,1251050,0,0,3,0,0,0,3,0,0,0,0,3,0,3,6
2797,68522478,2685200,2685250,1247800,1247850,0,3,3,0,0,0,6,0,0,3,0,3,0,6,12
2798,68522463,2685200,2685250,1246300,1246350,3,3,0,0,0,0,6,3,3,4,3,3,0,16,22
2799,68522510,2685200,2685250,1251000,1251050,0,0,0,0,0,0,0,0,0,0,0,0,0,0,0
2800,68522512,2685200,2685250,1251200,1251250,4,4,3,3,3,3,20,8,3,3,3,3,0,20,40
2801,68522482,2685200,2685250,1248200,1248250,3,3,0,3,0,0,9,3,3,0,3,3,0,12,21
2802,68522514,2685200,2685250,1251400,1251450,3,0,3,0,0,0,6,3,0,0,0,0,0,3,9
2803,68532465,2685300,2685350,1246500,1246550,3,3,3,3,3,0,15,3,3,0,3,3,0,12,27
2804,68532466,2685300,2685350,1246600,1246650,3,3,3,0,0,3,12,0,3,0,0,3,3,9,21
2805,68532472,2685300,2685350,1247200,1247250,3,3,0,0,0,0,6,0,0,0,0,0,0,0,6
2806,68532450,2685300,2685350,1245000,1245050,3,3,3,3,3,0,15,3,3,0,3,3,3,15,30
2807,68532457,2685300,2685350,1245700,1245750,0,3,0,0,0,0,3,0,0,3,0,0,0,3,6
2808,68532509,2685300,2685350,1250900,1250950,5,3,0,3,3,3,17,3,3,3,3,3,3,18,35
2809,68552509,2685500,2685550,1250900,1250950,3,3,4,3,0,0,13,7,4,3,3,3,0,20,33
2810,68552461,2685500,2685550,1246100,1246150,3,3,3,0,3,0,12,3,3,3,3,0,0,12,24
2811,68552481,2685500,2685550,1248100,1248150,0,0,0,0,0,0,0,0,0,0,0,0,0,0,0
2812,68562455,2685600,2685650,1245500,1245550,6,3,5,3,3,0,20,4,6,3,3,3,0,19,39
2813,68562507,2685600,2685650,1250700,1250750,3,0,3,3,0,0,9,3,0,0,0,0,0,3,12
2814,68572514,2685700,2685750,1251400,1251450,0,4,3,3,3,0,13,3,3,0,3,0,0,9,22
2815,68582515,2685800,2685850,1251500,1251550,3,3,3,3,3,0,15,3,3,0,3,3,3,15,30
2816,68582514,2685800,2685850,1251400,1251450,4,3,3,0,0,3,13,3,3,3,3,3,0,15,28
2817,68582475,2685800,2685850,1247500,1247550,3,0,0,0,3,0,6,0,0,0,0,3,3,6,12
2818,68592509,2685900,2685950,1250900,1250950,3,3,0,3,3,0,12,3,0,3,3,0,0,9,21
2819,68592510,2685900,2685950,1251000,1251050,3,0,3,0,0,0,6,3,3,4,0,0,3,13,19
2820,68592448,2685900,2685950,1244800,1244850,0,3,0,3,0,0,6,3,0,0,3,0,0,6,12
2821,68592449,2685900,2685950,1244900,1244950,0,3,3,0,0,0,6,3,0,3,0,0,0,6,12
2822,68592460,2685900,2685950,1246000,1246050,3,3,3,3,0,0,12,3,3,3,0,0,0,9,21
2823,68602514,2686000,2686050,1251400,1251450,3,3,0,0,0,0,6,3,0,0,0,0,0,3,9
2824,68622509,2686200,2686250,1250900,1250950,0,4,3,3,0,3,13,6,3,3,3,3,3,21,34
2825,68632515,2686300,2686350,1251500,1251550,0,0,3,0,0,0,3,0,0,3,3,0,0,6,9
2826,68632510,2686300,2686350,1251000,1251050,0,0,0,0,0,0,0,0,0,0,0,0,0,0,0
2827,68642458,2686400,2686450,1245800,1245850,3,3,0,0,0,0,6,3,0,3,0,0,0,6,12
2828,68642452,2686400,2686450,1245200,1245250,0,0,0,0,0,0,0,0,0,0,0,0,0,0,0
2829,68652461,2686500,2686550,1246100,1246150,3,3,0,3,3,3,15,3,3,3,3,3,3,18,33
2830,68662503,2686600,2686650,1250300,1250350,3,3,0,3,3,3,15,3,0,0,3,0,3,9,24
2831,68662509,2686600,2686650,1250900,1250950,3,3,3,0,3,0,12,3,3,0,3,3,0,12,24
2832,68672487,2686700,2686750,1248700,1248750,3,0,0,0,0,0,3,3,0,0,0,0,0,3,6
2833,68672459,2686700,2686750,1245900,1245950,3,0,3,3,3,3,15,4,3,4,4,3,0,18,33
2834,68702502,2687000,2687050,1250200,1250250,3,4,0,0,3,0,10,0,3,3,3,3,0,12,22
2835,68712506,2687100,2687150,1250600,1250650,0,0,0,0,0,0,0,0,0,0,0,0,0,0,0
2836,68712505,2687100,2687150,1250500,1250550,13,15,10,9,3,3,53,22,28,25,16,9,4,104,157
2837,68722502,2687200,2687250,1250200,1250250,3,3,0,0,0,0,6,3,3,0,0,0,0,6,12
2838,68732466,2687300,2687350,1246600,1246650,3,3,3,3,3,0,15,3,3,3,3,0,0,12,27
2839,68742461,2687400,2687450,1246100,1246150,3,3,0,0,0,0,6,3,3,0,0,3,0,9,15
2840,68752466,2687500,2687550,1246600,1246650,3,3,3,3,3,0,15,4,3,3,3,0,0,13,28
2841,68782457,2687800,2687850,1245700,1245750,3,3,3,0,3,0,12,3,4,3,3,3,0,16,28
2842,68802456,2688000,2688050,1245600,1245650,3,0,3,0,0,3,9,3,3,3,3,0,0,12,21
2843,68602456,2686000,2686050,1245600,1245650,0,0,0,0,0,0,0,0,0,0,0,0,0,0,0
2844,67882502,2678800,2678850,1250200,1250250,0,3,0,0,0,0,3,0,0,0,0,0,0,0,3
2845,68282485,2682800,2682850,1248500,1248550,0,3,0,0,0,0,3,0,0,3,0,0,0,3,6
2846,68092477,2680900,2680950,1247700,1247750,0,0,0,0,0,0,0,0,0,0,0,0,0,0,0
2847,68192520,2681900,2681950,1252000,1252050,3,0,3,0,3,0,9,0,3,3,3,3,0,12,21
2848,68192482,2681900,2681950,1248200,1248250,6,3,5,3,3,3,23,9,4,11,3,0,3,30,53
2849,68192469,2681900,2681950,1246900,1246950,3,3,3,3,0,0,12,0,3,3,0,0,0,6,18
2850,68192495,2681900,2681950,1249500,1249550,0,0,0,0,0,0,0,0,0,0,0,0,0,0,0
2851,68202464,2682000,2682050,1246400,1246450,3,3,3,0,0,0,9,0,3,0,3,0,3,9,18
2852,68202435,2682000,2682050,1243500,1243550,3,3,3,0,0,0,9,3,3,3,0,0,0,9,18
2853,68202434,2682000,2682050,1243400,1243450,3,3,3,3,3,0,15,3,3,3,3,0,0,12,27
2854,68202491,2682000,2682050,1249100,1249150,3,3,3,0,0,0,9,0,0,0,0,3,0,3,12
2855,68212447,2682100,2682150,1244700,1244750,3,3,3,3,0,0,12,3,3,3,4,3,0,16,28
2856,68212483,2682100,2682150,1248300,1248350,3,0,3,0,0,0,6,3,3,0,3,0,0,9,15
2857,68212441,2682100,2682150,1244100,1244150,3,4,3,0,3,0,13,4,3,3,0,3,3,16,29
2858,68212445,2682100,2682150,1244500,1244550,3,3,3,0,0,0,9,3,3,3,0,0,0,9,18
2859,68212460,2682100,2682150,1246000,1246050,0,3,0,0,3,0,6,4,4,5,3,3,3,22,28
2860,68212499,2682100,2682150,1249900,1249950,3,3,3,0,0,0,9,3,3,3,0,0,0,9,18
2861,68212498,2682100,2682150,1249800,1249850,3,3,3,0,0,0,9,3,0,0,3,0,0,6,15
2862,68212510,2682100,2682150,1251000,1251050,0,0,0,0,0,0,0,0,0,0,0,0,0,0,0
2863,68222520,2682200,2682250,1252000,1252050,3,3,3,0,0,0,9,0,0,3,0,0,0,3,12
2864,68222471,2682200,2682250,1247100,1247150,3,0,3,3,0,0,9,3,3,3,0,0,0,9,18
2865,68222475,2682200,2682250,1247500,1247550,3,3,3,0,0,0,9,8,5,4,0,0,0,17,26
2866,68222441,2682200,2682250,1244100,1244150,3,3,3,3,3,0,15,3,3,4,3,3,0,16,31
2867,68222519,2682200,2682250,1251900,1251950,3,3,3,0,0,0,9,3,3,0,3,0,0,9,18
2868,68222491,2682200,2682250,1249100,1249150,3,0,0,0,0,0,3,0,0,0,0,0,0,0,3
2869,68232459,2682300,2682350,1245900,1245950,0,3,3,3,0,0,9,3,3,3,3,3,0,15,24
2870,68232486,2682300,2682350,1248600,1248650,4,3,3,3,3,0,16,0,3,3,0,0,3,9,25
2871,68232514,2682300,2682350,1251400,1251450,3,3,3,3,3,0,15,0,0,3,3,3,0,9,24
2872,68232430,2682300,2682350,1243000,1243050,4,3,6,3,3,0,19,7,8,3,4,4,3,29,48
2873,68232440,2682300,2682350,1244000,1244050,3,3,3,3,0,3,15,3,3,3,3,3,3,18,33
2874,68232461,2682300,2682350,1246100,1246150,0,0,0,0,0,0,0,0,0,0,0,0,0,0,0
2875,68232494,2682300,2682350,1249400,1249450,6,6,3,4,3,4,26,4,3,4,4,5,3,23,49
2876,68232467,2682300,2682350,1246700,1246750,3,0,3,0,0,0,6,0,3,0,0,0,0,3,9
2877,68242488,2682400,2682450,1248800,1248850,6,4,3,3,0,0,16,7,3,4,3,3,0,20,36
2878,68242461,2682400,2682450,1246100,1246150,0,3,3,3,0,0,9,3,0,0,3,3,0,9,18
2879,68242517,2682400,2682450,1251700,1251750,3,3,4,3,0,0,13,6,3,3,3,3,0,18,31
2880,68242443,2682400,2682450,1244300,1244350,3,3,0,4,3,3,16,3,3,6,3,3,3,21,37
2881,68242437,2682400,2682450,1243700,1243750,3,3,5,0,0,0,11,3,3,3,3,3,0,15,26
2882,68242494,2682400,2682450,1249400,1249450,3,3,0,0,0,0,6,4,3,3,3,0,3,16,22
2883,68242447,2682400,2682450,1244700,1244750,3,3,4,0,3,0,13,3,3,3,3,3,0,15,28
2884,68252516,2682500,2682550,1251600,1251650,4,0,0,0,0,0,4,3,3,3,0,0,0,9,13
2885,68252485,2682500,2682550,1248500,1248550,3,3,0,0,0,0,6,3,0,3,3,3,0,12,18
2886,68252497,2682500,2682550,1249700,1249750,4,4,3,0,3,0,14,4,3,5,3,3,3,21,35
2887,68252466,2682500,2682550,1246600,1246650,3,3,3,0,0,0,9,0,3,3,0,0,0,6,15
2888,68262447,2682600,2682650,1244700,1244750,3,3,3,3,0,0,12,3,4,0,0,3,3,13,25
2889,68262474,2682600,2682650,1247400,1247450,3,0,0,0,0,3,6,3,3,3,0,0,0,9,15
2890,68262441,2682600,2682650,1244100,1244150,3,3,3,0,0,0,9,3,3,3,0,3,0,12,21
2891,68262512,2682600,2682650,1251200,1251250,3,3,3,3,0,3,15,4,7,3,3,0,3,20,35
2892,68262439,2682600,2682650,1243900,1243950,0,3,3,0,0,0,6,3,0,3,0,0,0,6,12
2893,68262478,2682600,2682650,1247800,1247850,0,0,0,0,0,0,0,0,0,0,0,0,0,0,0
2894,68272511,2682700,2682750,1251100,1251150,3,3,0,0,0,0,6,3,0,3,0,3,0,9,15
2895,68272494,2682700,2682750,1249400,1249450,3,4,3,3,3,0,16,3,5,3,3,3,3,20,36
2896,68272442,2682700,2682750,1244200,1244250,6,0,3,3,0,3,15,4,3,3,3,3,3,19,34
2897,68272449,2682700,2682750,1244900,1244950,0,0,0,0,0,0,0,0,0,0,0,0,0,0,0
2898,68272484,2682700,2682750,1248400,1248450,3,0,3,3,0,3,12,3,3,3,3,0,4,16,28
2899,68272512,2682700,2682750,1251200,1251250,0,0,3,0,0,0,3,0,0,0,0,3,0,3,6
2900,68272439,2682700,2682750,1243900,1243950,0,0,0,0,0,0,0,0,0,0,0,0,0,0,0
2901,68282484,2682800,2682850,1248400,1248450,0,3,0,0,0,0,3,3,0,0,0,0,0,3,6
2902,68282524,2682800,2682850,1252400,1252450,0,0,0,0,0,0,0,0,3,3,0,0,0,6,6
2903,68282443,2682800,2682850,1244300,1244350,0,0,0,0,0,0,0,0,0,0,0,0,0,0,0
2904,68292517,2682900,2682950,1251700,1251750,0,3,0,0,0,0,3,3,0,0,0,0,0,3,6
2905,68292434,2682900,2682950,1243400,1243450,3,3,0,0,0,0,6,5,0,3,3,3,0,14,20
2906,68292466,2682900,2682950,1246600,1246650,3,3,3,3,0,0,12,3,7,4,0,3,3,20,32
2907,68302435,2683000,2683050,1243500,1243550,0,3,0,0,0,3,6,3,0,4,0,3,0,10,16
2908,68302439,2683000,2683050,1243900,1243950,3,0,0,0,0,0,3,0,0,0,0,0,0,0,3
2909,68302533,2683000,2683050,1253300,1253350,0,0,0,0,0,0,0,0,0,0,0,0,0,0,0
2910,68312527,2683100,2683150,1252700,1252750,3,3,0,3,3,0,12,3,4,0,3,3,0,13,25
2911,68312490,2683100,2683150,1249000,1249050,4,0,3,3,3,0,13,6,3,4,3,0,0,16,29
2912,68312506,2683100,2683150,1250600,1250650,0,0,3,3,0,0,6,0,0,0,3,3,0,6,12
2913,68322506,2683200,2683250,1250600,1250650,3,3,3,0,3,0,12,3,3,0,3,3,3,15,27
2914,68322435,2683200,2683250,1243500,1243550,0,3,3,0,0,0,6,0,0,0,0,0,0,0,6
2915,68322469,2683200,2683250,1246900,1246950,0,3,0,0,0,0,3,3,0,0,0,0,0,3,6
2916,68322479,2683200,2683250,1247900,1247950,0,0,0,0,0,0,0,0,0,0,0,0,0,0,0
2917,68332524,2683300,2683350,1252400,1252450,12,12,5,4,3,0,36,11,11,8,3,3,3,39,75
2918,68342511,2683400,2683450,1251100,1251150,3,0,3,0,3,0,9,3,3,3,3,0,0,12,21
2919,68342532,2683400,2683450,1253200,1253250,3,0,0,0,0,0,3,3,0,0,3,0,0,6,9
2920,68342516,2683400,2683450,1251600,1251650,3,3,0,0,0,0,6,3,3,0,0,0,0,6,12
2921,68342534,2683400,2683450,1253400,1253450,3,0,3,0,0,0,6,0,3,0,0,3,3,9,15
2922,68342480,2683400,2683450,1248000,1248050,0,0,0,0,0,0,0,0,0,0,0,0,0,0,0
2923,68352539,2683500,2683550,1253900,1253950,0,3,0,0,0,0,3,3,0,3,0,0,3,9,12
2924,68352510,2683500,2683550,1251000,1251050,3,0,3,0,0,0,6,3,0,3,0,0,0,6,12
2925,68352537,2683500,2683550,1253700,1253750,5,3,0,3,0,0,11,7,0,0,3,3,0,13,24
2926,68352471,2683500,2683550,1247100,1247150,6,4,4,3,0,3,20,3,3,3,3,3,0,15,35
2927,68362489,2683600,2683650,1248900,1248950,0,0,3,3,0,0,6,3,3,0,3,0,3,12,18
2928,68362530,2683600,2683650,1253000,1253050,3,3,3,3,3,0,15,5,0,0,3,3,0,11,26
2929,68372464,2683700,2683750,1246400,1246450,3,4,3,0,0,0,10,0,3,3,0,0,0,6,16
2930,68372521,2683700,2683750,1252100,1252150,3,0,3,0,0,0,6,3,3,3,3,0,0,12,18
2931,68382507,2683800,2683850,1250700,1250750,3,3,0,3,0,3,12,3,5,6,3,3,3,23,35
2932,68382496,2683800,2683850,1249600,1249650,3,3,3,3,3,0,15,0,3,3,3,3,0,12,27
2933,68382473,2683800,2683850,1247300,1247350,3,3,3,0,0,0,9,3,0,0,0,0,0,3,12
2934,68392531,2683900,2683950,1253100,1253150,3,3,3,0,0,0,9,3,0,3,0,0,0,6,15
2935,68392471,2683900,2683950,1247100,1247150,3,0,0,3,3,0,9,3,0,3,0,3,0,9,18
2936,68392537,2683900,2683950,1253700,1253750,3,3,0,0,0,0,6,3,0,3,0,0,0,6,12
2937,68402493,2684000,2684050,1249300,1249350,3,0,0,0,0,0,3,3,0,0,0,3,0,6,9
2938,68402508,2684000,2684050,1250800,1250850,3,3,3,3,0,0,12,3,3,3,3,0,4,16,28
2939,68412460,2684100,2684150,1246000,1246050,0,3,3,3,3,0,12,3,3,3,0,3,3,15,27
2940,68412487,2684100,2684150,1248700,1248750,4,3,3,0,3,3,16,3,3,3,3,3,0,15,31
2941,68412506,2684100,2684150,1250600,1250650,0,3,0,3,0,0,6,3,3,0,3,3,3,15,21
2942,68412503,2684100,2684150,1250300,1250350,3,3,0,3,0,0,9,0,3,3,3,0,0,9,18
2943,68412466,2684100,2684150,1246600,1246650,3,0,0,0,0,0,3,3,3,0,0,0,0,6,9
2944,68432468,2684300,2684350,1246800,1246850,0,0,3,3,0,0,6,3,3,3,0,0,0,9,15
2945,68442481,2684400,2684450,1248100,1248150,3,4,3,3,0,0,13,7,3,3,0,3,0,16,29
2946,68442474,2684400,2684450,1247400,1247450,0,3,3,0,0,0,6,3,3,3,3,3,0,15,21
2947,68442515,2684400,2684450,1251500,1251550,3,3,3,3,0,3,15,0,3,3,0,3,3,12,27
2948,68442462,2684400,2684450,1246200,1246250,0,0,0,0,0,0,0,0,3,0,0,0,0,3,3
2949,68452510,2684500,2684550,1251000,1251050,3,3,3,0,0,0,9,3,3,0,3,3,0,12,21
2950,68452458,2684500,2684550,1245800,1245850,3,3,3,0,3,0,12,5,5,3,3,3,0,19,31
2951,68452508,2684500,2684550,1250800,1250850,3,0,0,0,0,0,3,0,3,3,0,0,0,6,9
2952,68452463,2684500,2684550,1246300,1246350,3,0,0,0,0,0,3,3,3,0,0,0,0,6,9
2953,68452523,2684500,2684550,1252300,1252350,0,3,3,0,0,0,6,0,0,0,0,0,0,0,6
2954,68452518,2684500,2684550,1251800,1251850,3,3,3,0,0,3,12,3,3,3,0,0,3,12,24
2955,68462454,2684600,2684650,1245400,1245450,6,5,3,0,3,0,17,6,6,4,3,3,0,22,39
2956,68462458,2684600,2684650,1245800,1245850,3,3,3,0,0,0,9,3,3,0,0,0,0,6,15
2957,68462477,2684600,2684650,1247700,1247750,3,0,3,3,0,3,12,3,0,3,3,3,0,12,24
2958,68472517,2684700,2684750,1251700,1251750,0,3,3,0,0,0,6,4,3,0,0,0,0,7,13
2959,68472468,2684700,2684750,1246800,1246850,3,6,3,5,3,0,20,3,4,3,3,0,3,16,36
2960,68472466,2684700,2684750,1246600,1246650,5,3,3,0,0,3,14,3,3,3,0,3,3,15,29
2961,68472475,2684700,2684750,1247500,1247550,3,3,3,0,0,0,9,3,4,3,0,0,0,10,19
2962,68482453,2684800,2684850,1245300,1245350,3,3,0,3,0,0,9,3,3,3,3,0,0,12,21
2963,68482449,2684800,2684850,1244900,1244950,0,0,3,0,0,0,3,0,0,0,0,0,0,0,3
2964,68482483,2684800,2684850,1248300,1248350,0,3,0,0,0,0,3,0,3,0,0,0,0,3,6
2965,68482450,2684800,2684850,1245000,1245050,3,3,3,0,0,0,9,4,3,0,0,0,0,7,16
2966,68492455,2684900,2684950,1245500,1245550,3,3,3,0,3,0,12,3,3,3,3,0,0,12,24
2967,68492471,2684900,2684950,1247100,1247150,3,4,3,3,3,0,16,3,3,3,3,3,0,15,31
2968,68502516,2685000,2685050,1251600,1251650,3,3,3,3,3,3,18,3,3,3,3,0,0,12,30
2969,68502481,2685000,2685050,1248100,1248150,0,3,0,0,0,0,3,0,0,3,3,0,3,9,12
2970,68512477,2685100,2685150,1247700,1247750,3,3,3,3,3,0,15,0,0,3,3,3,0,9,24
2971,68512519,2685100,2685150,1251900,1251950,0,0,0,0,0,0,0,0,3,0,0,3,0,6,6
2972,68512513,2685100,2685150,1251300,1251350,3,0,3,3,0,0,9,3,3,3,0,0,0,9,18
2973,68522473,2685200,2685250,1247300,1247350,3,3,0,0,0,0,6,3,0,0,0,0,0,3,9
2974,68522481,2685200,2685250,1248100,1248150,0,3,0,3,0,0,6,3,3,0,0,0,0,6,12
2975,68522517,2685200,2685250,1251700,1251750,3,3,3,0,0,0,9,3,3,3,3,3,3,18,27
2976,68532521,2685300,2685350,1252100,1252150,0,0,0,0,0,0,0,0,0,0,0,0,0,0,0
2977,68532461,2685300,2685350,1246100,1246150,3,3,0,3,3,0,12,3,3,0,0,3,3,12,24
2978,68542483,2685400,2685450,1248300,1248350,0,0,0,0,0,0,0,0,0,0,0,0,3,3,3
2979,68542510,2685400,2685450,1251000,1251050,3,3,3,0,0,0,9,4,3,3,3,3,0,16,25
2980,68542450,2685400,2685450,1245000,1245050,3,3,3,0,3,0,12,3,3,3,3,3,0,15,27
2981,68552522,2685500,2685550,1252200,1252250,0,0,0,0,0,0,0,0,0,0,0,0,0,0,0
2982,68582488,2685800,2685850,1248800,1248850,4,0,3,3,0,0,10,3,3,0,3,0,0,9,19
2983,68582459,2685800,2685850,1245900,1245950,3,0,0,0,0,0,3,0,0,0,0,0,0,0,3
2984,68592516,2685900,2685950,1251600,1251650,0,3,0,0,0,0,3,3,0,0,0,0,0,3,6
2985,68602459,2686000,2686050,1245900,1245950,3,3,3,3,0,0,12,3,3,0,3,0,0,9,21
2986,68612453,2686100,2686150,1245300,1245350,3,3,0,0,0,0,6,3,3,3,0,0,0,9,15
2987,68622513,2686200,2686250,1251300,1251350,3,3,3,3,3,0,15,7,3,3,8,4,3,28,43
2988,68632452,2686300,2686350,1245200,1245250,3,3,3,3,0,0,12,3,0,3,0,0,0,6,18
2989,68632457,2686300,2686350,1245700,1245750,0,3,3,3,3,0,12,3,0,3,3,0,0,9,21
2990,68632453,2686300,2686350,1245300,1245350,0,0,0,0,0,0,0,0,0,0,0,0,0,0,0
2991,68642506,2686400,2686450,1250600,1250650,3,4,0,0,0,0,7,3,3,0,0,3,0,9,16
2992,68642505,2686400,2686450,1250500,1250550,3,4,4,3,3,0,17,3,5,6,3,3,3,23,40
2993,68642455,2686400,2686450,1245500,1245550,3,0,0,3,0,0,6,3,0,3,3,3,3,15,21
2994,68642503,2686400,2686450,1250300,1250350,3,3,3,3,3,0,15,3,4,3,3,3,0,16,31
2995,68652504,2686500,2686550,1250400,1250450,3,3,3,0,3,3,15,3,4,3,3,0,0,13,28
2996,68652476,2686500,2686550,1247600,1247650,0,0,0,0,0,0,0,0,0,0,0,0,3,3,3
2997,68662456,2686600,2686650,1245600,1245650,3,0,0,0,0,0,3,3,0,0,0,0,0,3,6
2998,68662462,2686600,2686650,1246200,1246250,3,3,4,3,3,0,16,3,4,4,3,3,0,17,33
2999,68672486,2686700,2686750,1248600,1248650,3,3,0,0,0,0,6,0,3,0,0,0,0,3,9
3000,68682461,2686800,2686850,1246100,1246150,3,3,3,3,3,3,18,5,3,5,3,6,0,22,40
3001,68682506,2686800,2686850,1250600,1250650,0,0,0,0,0,0,0,0,4,0,0,0,0,4,4
3002,68692462,2686900,2686950,1246200,1246250,3,3,3,3,0,3,15,3,7,3,4,3,3,23,38
3003,68712462,2687100,2687150,1246200,1246250,0,0,0,0,0,3,3,0,0,0,0,3,0,3,6
3004,68722466,2687200,2687250,1246600,1246650,0,3,3,0,0,0,6,3,3,3,0,0,0,9,15
3005,68732461,2687300,2687350,1246100,1246150,3,3,3,0,0,0,9,3,0,3,0,0,3,9,18
3006,68732503,2687300,2687350,1250300,1250350,3,0,3,0,0,0,6,3,3,0,3,3,0,12,18
3007,68732456,2687300,2687350,1245600,1245650,3,0,0,3,10,12,28,0,3,5,8,10,35,61,89
3008,68742453,2687400,2687450,1245300,1245350,0,0,0,0,0,0,0,3,0,0,3,0,0,6,6
3009,68752457,2687500,2687550,1245700,1245750,3,3,3,3,0,0,12,4,3,3,3,0,0,13,25
3010,68762454,2687600,2687650,1245400,1245450,5,3,3,3,5,3,22,3,3,8,8,10,22,54,76
3011,68762461,2687600,2687650,1246100,1246150,3,3,3,3,3,3,18,3,3,4,3,4,0,17,35
3012,68772454,2687700,2687750,1245400,1245450,3,3,3,3,4,0,16,3,3,9,5,3,3,26,42
3013,67772494,2677700,2677750,1249400,1249450,3,3,3,6,4,7,26,3,5,3,3,19,30,63,89
3014,67792495,2677900,2677950,1249500,1249550,3,0,4,3,0,0,10,3,4,3,3,3,3,19,29
3015,67792492,2677900,2677950,1249200,1249250,6,3,3,3,3,3,21,6,3,4,4,0,3,20,41
3016,67802492,2678000,2678050,1249200,1249250,0,3,6,0,0,0,9,3,4,3,3,3,3,19,28
3017,67812521,2678100,2678150,1252100,1252150,3,3,0,0,0,0,6,0,3,3,0,0,0,6,12
3018,67822522,2678200,2678250,1252200,1252250,3,0,0,0,3,0,6,0,0,0,3,0,3,6,12
3019,67842490,2678400,2678450,1249000,1249050,3,3,0,0,3,0,9,3,0,3,3,0,0,9,18
3020,67842518,2678400,2678450,1251800,1251850,3,0,0,0,0,0,3,0,3,0,0,0,0,3,6
3021,67852492,2678500,2678550,1249200,1249250,3,0,3,3,0,0,9,3,0,3,5,3,3,17,26
3022,67862483,2678600,2678650,1248300,1248350,4,0,3,3,0,3,13,3,3,3,0,3,0,12,25
3023,67872490,2678700,2678750,1249000,1249050,0,0,0,0,0,0,0,3,0,0,0,0,0,3,3
3024,67872514,2678700,2678750,1251400,1251450,3,0,3,0,0,0,6,5,3,0,0,0,3,11,17
3025,67872479,2678700,2678750,1247900,1247950,6,3,3,3,3,0,18,7,3,3,3,3,3,22,40
3026,67882484,2678800,2678850,1248400,1248450,3,3,0,3,3,0,12,3,3,3,3,3,0,15,27
3027,67882479,2678800,2678850,1247900,1247950,3,0,0,0,3,0,6,5,3,3,3,0,0,14,20
3028,67882482,2678800,2678850,1248200,1248250,4,0,0,3,0,3,10,3,3,3,3,3,3,18,28
3029,67892473,2678900,2678950,1247300,1247350,3,3,3,0,0,0,9,5,3,0,3,3,0,14,23
3030,67892489,2678900,2678950,1248900,1248950,0,3,3,0,0,0,6,3,3,0,0,0,0,6,12
3031,67902484,2679000,2679050,1248400,1248450,3,3,3,3,3,0,15,5,3,3,3,3,0,17,32
3032,67902517,2679000,2679050,1251700,1251750,3,0,3,0,0,0,6,3,3,3,0,0,3,12,18
3033,67902468,2679000,2679050,1246800,1246850,0,0,0,3,0,0,3,0,0,0,0,0,0,0,3
3034,67912500,2679100,2679150,1250000,1250050,3,3,0,3,3,0,12,3,0,3,0,3,0,9,21
3035,67922468,2679200,2679250,1246800,1246850,3,3,3,0,0,0,9,0,4,3,0,3,0,10,19
3036,67922503,2679200,2679250,1250300,1250350,3,0,0,0,0,0,3,0,0,0,0,0,0,0,3
3037,67932482,2679300,2679350,1248200,1248250,0,3,3,0,0,0,6,3,3,0,0,0,0,6,12
3038,67942511,2679400,2679450,1251100,1251150,0,3,3,0,3,0,9,3,0,3,3,3,0,12,21
3039,67942476,2679400,2679450,1247600,1247650,4,3,3,3,3,0,16,7,3,3,3,3,3,22,38
3040,67942479,2679400,2679450,1247900,1247950,3,3,3,3,0,0,12,4,4,3,0,0,0,11,23
3041,67952508,2679500,2679550,1250800,1250850,3,3,3,3,3,0,15,3,3,5,3,3,3,20,35
3042,67952477,2679500,2679550,1247700,1247750,3,3,3,3,0,0,12,3,3,3,3,3,0,15,27
3043,67952483,2679500,2679550,1248300,1248350,0,0,0,0,0,0,0,0,0,0,0,0,0,0,0
3044,67962468,2679600,2679650,1246800,1246850,3,4,3,3,0,3,16,3,5,0,3,4,3,18,34
3045,67962505,2679600,2679650,1250500,1250550,3,4,3,3,3,0,16,3,3,3,3,3,0,15,31
3046,67962513,2679600,2679650,1251300,1251350,3,3,0,3,3,0,12,3,0,3,3,3,3,15,27
3047,67962476,2679600,2679650,1247600,1247650,0,3,3,0,3,3,12,3,3,3,0,3,3,15,27
3048,67962471,2679600,2679650,1247100,1247150,3,3,3,4,3,3,19,4,3,8,5,7,0,27,46
3049,67962477,2679600,2679650,1247700,1247750,3,3,3,4,0,0,13,4,4,4,5,3,3,23,36
3050,67962489,2679600,2679650,1248900,1248950,0,0,0,0,0,0,0,0,0,0,0,0,0,0,0
3051,67972480,2679700,2679750,1248000,1248050,0,0,0,0,0,0,0,0,0,0,0,0,0,0,0
3052,67972492,2679700,2679750,1249200,1249250,0,0,0,0,0,0,0,3,3,0,0,0,0,6,6
3053,67972496,2679700,2679750,1249600,1249650,0,0,0,0,0,0,0,0,0,0,0,0,0,0,0
3054,67982483,2679800,2679850,1248300,1248350,0,0,0,0,3,0,3,3,0,3,3,0,0,9,12
3055,67982530,2679800,2679850,1253000,1253050,3,3,3,0,3,0,12,3,0,3,3,3,0,12,24
3056,67982465,2679800,2679850,1246500,1246550,3,0,0,0,0,3,6,0,0,0,0,3,0,3,9
3057,67982491,2679800,2679850,1249100,1249150,3,0,0,0,0,0,3,0,0,3,0,0,0,3,6
3058,67992487,2679900,2679950,1248700,1248750,3,0,4,0,3,0,10,3,3,0,3,0,0,9,19
3059,67992490,2679900,2679950,1249000,1249050,0,0,0,0,0,0,0,0,0,0,0,0,0,0,0
3060,67992529,2679900,2679950,1252900,1252950,0,3,0,0,0,3,6,0,0,0,3,3,0,6,12
3061,67992530,2679900,2679950,1253000,1253050,0,0,0,0,0,0,0,0,0,0,0,0,0,0,0
3062,67992505,2679900,2679950,1250500,1250550,0,0,0,0,0,0,0,0,0,0,0,0,0,0,0
3063,68002528,2680000,2680050,1252800,1252850,5,3,3,3,3,0,17,3,3,3,0,3,0,12,29
3064,68012486,2680100,2680150,1248600,1248650,3,5,4,3,3,0,18,7,3,3,3,0,3,19,37
3065,68012469,2680100,2680150,1246900,1246950,3,0,3,3,3,0,12,0,0,3,3,0,0,6,18
3066,68012459,2680100,2680150,1245900,1245950,0,0,0,3,0,0,3,0,0,0,0,3,0,3,6
3067,68022502,2680200,2680250,1250200,1250250,0,3,0,0,0,0,3,3,3,3,3,3,0,15,18
3068,68022474,2680200,2680250,1247400,1247450,4,3,0,3,3,3,16,3,3,3,3,4,3,19,35
3069,68022509,2680200,2680250,1250900,1250950,3,3,3,6,3,3,21,3,3,4,3,3,3,19,40
3070,68032462,2680300,2680350,1246200,1246250,3,6,4,3,3,0,19,7,6,5,3,0,0,21,40
3071,68032469,2680300,2680350,1246900,1246950,3,0,0,0,3,0,6,3,0,0,3,0,0,6,12
3072,68032464,2680300,2680350,1246400,1246450,3,0,0,0,0,0,3,0,3,0,0,0,0,3,6
3073,68032533,2680300,2680350,1253300,1253350,0,3,0,0,0,0,3,3,3,0,0,0,0,6,9
3074,68042474,2680400,2680450,1247400,1247450,3,4,3,3,0,0,13,3,0,5,3,0,0,11,24
3075,68042489,2680400,2680450,1248900,1248950,0,3,0,3,0,0,6,0,3,0,3,0,0,6,12
3076,68042527,2680400,2680450,1252700,1252750,0,3,3,0,3,0,9,4,3,3,3,3,0,16,25
3077,68042512,2680400,2680450,1251200,1251250,0,0,0,0,0,0,0,0,0,0,0,0,0,0,0
3078,68052500,2680500,2680550,1250000,1250050,3,3,3,0,0,3,12,3,5,0,0,3,3,14,26
3079,68052527,2680500,2680550,1252700,1252750,0,0,4,3,3,0,10,3,3,3,3,0,0,12,22
3080,68052457,2680500,2680550,1245700,1245750,0,0,0,0,0,0,0,0,0,0,0,0,0,0,0
3081,68062521,2680600,2680650,1252100,1252150,4,5,4,3,3,0,19,5,3,7,3,3,0,21,40
3082,68062520,2680600,2680650,1252000,1252050,0,3,0,0,0,0,3,3,0,0,0,0,0,3,6
3083,68062481,2680600,2680650,1248100,1248150,0,3,0,0,0,0,3,5,3,3,0,0,3,14,17
3084,68072461,2680700,2680750,1246100,1246150,4,3,3,3,0,0,13,6,3,3,0,3,3,18,31
3085,68072523,2680700,2680750,1252300,1252350,5,3,0,0,3,0,11,3,3,3,0,3,0,12,23
3086,68072500,2680700,2680750,1250000,1250050,4,4,3,3,3,3,20,3,3,3,3,3,0,15,35
3087,68072462,2680700,2680750,1246200,1246250,0,0,0,0,0,0,0,0,0,0,0,0,0,0,0
3088,68072524,2680700,2680750,1252400,1252450,3,3,3,0,0,3,12,3,0,3,0,0,0,6,18
3089,68072473,2680700,2680750,1247300,1247350,3,3,3,3,3,0,15,4,3,3,3,3,3,19,34
3090,68072479,2680700,2680750,1247900,1247950,0,0,0,0,0,0,0,0,0,0,0,0,0,0,0
3091,68072517,2680700,2680750,1251700,1251750,3,0,0,3,3,0,9,3,0,0,3,0,0,6,15
3092,68082463,2680800,2680850,1246300,1246350,0,3,3,0,0,0,6,3,3,3,3,0,0,12,18
3093,68082532,2680800,2680850,1253200,1253250,3,0,0,0,0,0,3,3,3,3,0,0,0,9,12
3094,68082466,2680800,2680850,1246600,1246650,0,0,0,0,3,0,3,0,0,0,3,0,0,3,6
3095,68082523,2680800,2680850,1252300,1252350,3,3,3,0,0,0,9,3,4,0,3,0,0,10,19
3096,68082453,2680800,2680850,1245300,1245350,3,3,3,3,0,0,12,3,0,3,0,3,0,9,21
3097,68092529,2680900,2680950,1252900,1252950,3,3,3,3,0,0,12,3,3,4,3,3,0,16,28
3098,68092526,2680900,2680950,1252600,1252650,3,3,0,4,0,0,10,3,3,3,3,0,0,12,22
3099,68092486,2680900,2680950,1248600,1248650,3,3,0,0,0,0,6,3,0,0,3,0,0,6,12
3100,68092421,2680900,2680950,1242100,1242150,5,4,3,0,3,0,15,3,3,3,3,0,0,12,27
3101,68102421,2681000,2681050,1242100,1242150,3,3,3,3,0,0,12,3,3,3,3,0,3,15,27
3102,68102457,2681000,2681050,1245700,1245750,3,3,4,3,3,0,16,5,4,3,3,3,0,18,34
3103,68102465,2681000,2681050,1246500,1246550,5,6,8,3,0,0,22,7,5,6,8,3,0,29,51
3104,68102470,2681000,2681050,1247000,1247050,7,3,3,3,0,0,16,5,5,3,0,3,3,19,35
3105,68102519,2681000,2681050,1251900,1251950,3,3,5,3,3,0,17,3,3,0,0,3,0,9,26
3106,68102452,2681000,2681050,1245200,1245250,3,3,3,3,3,3,18,3,3,6,3,5,3,23,41
3107,68112520,2681100,2681150,1252000,1252050,3,0,0,0,3,0,6,3,3,3,3,3,0,15,21
3108,68112521,2681100,2681150,1252100,1252150,3,3,3,0,3,3,15,3,3,0,3,3,0,12,27
3109,68122521,2681200,2681250,1252100,1252150,3,3,3,3,0,0,12,3,0,0,3,3,0,9,21
3110,68122463,2681200,2681250,1246300,1246350,0,0,0,0,0,0,0,0,0,0,0,0,0,0,0
3111,68122497,2681200,2681250,1249700,1249750,3,0,3,0,0,0,6,3,3,3,0,0,0,9,15
3112,68132478,2681300,2681350,1247800,1247850,3,3,3,0,0,3,12,4,0,0,0,0,0,4,16
3113,68132490,2681300,2681350,1249000,1249050,0,3,0,0,0,0,3,3,3,0,0,0,0,6,9
3114,68132501,2681300,2681350,1250100,1250150,3,3,3,3,0,0,12,3,3,3,0,0,0,9,21
3115,68132508,2681300,2681350,1250800,1250850,0,0,0,0,0,0,0,0,0,0,0,0,0,0,0
3116,68132499,2681300,2681350,1249900,1249950,7,5,4,5,3,0,24,7,4,5,11,10,6,43,67
3117,68132491,2681300,2681350,1249100,1249150,0,0,0,0,0,0,0,0,0,0,0,0,0,0,0
3118,68142484,2681400,2681450,1248400,1248450,3,3,0,0,0,0,6,0,0,0,0,0,3,3,9
3119,68142503,2681400,2681450,1250300,1250350,0,0,3,3,0,0,6,0,3,3,0,0,0,6,12
3120,68142464,2681400,2681450,1246400,1246450,0,3,3,0,0,0,6,3,3,0,3,0,3,12,18
3121,68152431,2681500,2681550,1243100,1243150,3,3,3,0,0,0,9,3,3,3,3,3,0,15,24
3122,68152481,2681500,2681550,1248100,1248150,5,4,3,0,0,0,12,3,3,3,3,3,3,18,30
3123,68152496,2681500,2681550,1249600,1249650,3,0,0,0,0,0,3,3,0,0,3,0,0,6,9
3124,68152435,2681500,2681550,1243500,1243550,0,0,0,0,0,0,0,3,0,0,3,0,0,6,6
3125,68162470,2681600,2681650,1247000,1247050,3,6,3,0,3,0,15,3,7,6,3,3,0,22,37
3126,68162465,2681600,2681650,1246500,1246550,3,0,0,0,0,0,3,0,0,3,3,0,0,6,9
3127,68162476,2681600,2681650,1247600,1247650,3,3,3,0,0,0,9,8,3,3,0,0,0,14,23
3128,68172519,2681700,2681750,1251900,1251950,3,3,0,3,0,3,12,3,3,3,3,3,3,18,30
3129,68182469,2681800,2681850,1246900,1246950,3,3,3,0,0,0,9,3,5,0,0,0,3,11,20
3130,68182460,2681800,2681850,1246000,1246050,3,5,3,3,0,0,14,3,4,3,3,0,0,13,27
3131,68182520,2681800,2681850,1252000,1252050,3,0,3,0,3,0,9,3,3,0,0,3,0,9,18
3132,68192468,2681900,2681950,1246800,1246850,3,3,0,3,0,0,9,3,3,3,0,0,0,9,18
3133,68192478,2681900,2681950,1247800,1247850,3,6,4,3,3,0,19,7,5,6,3,3,0,24,43
3134,68192515,2681900,2681950,1251500,1251550,3,0,3,3,0,0,9,3,3,3,3,0,3,15,24
3135,68192496,2681900,2681950,1249600,1249650,0,0,0,0,0,0,0,0,0,3,0,0,0,3,3
3136,68202516,2682000,2682050,1251600,1251650,3,0,3,3,0,0,9,0,3,3,3,0,0,9,18
3137,68202483,2682000,2682050,1248300,1248350,3,0,3,0,0,0,6,0,3,0,0,0,0,3,9
3138,68202500,2682000,2682050,1250000,1250050,3,3,3,3,3,0,15,3,3,5,0,3,3,17,32
3139,68202473,2682000,2682050,1247300,1247350,3,4,0,0,0,3,10,3,3,0,0,3,0,9,19
3140,68202520,2682000,2682050,1252000,1252050,5,3,3,0,3,3,17,3,3,3,3,0,3,15,32
3141,68202497,2682000,2682050,1249700,1249750,3,3,3,0,0,0,9,3,3,3,3,3,0,15,24
3142,68212475,2682100,2682150,1247500,1247550,0,3,0,0,0,0,3,3,3,3,0,0,0,9,12
3143,68212516,2682100,2682150,1251600,1251650,3,3,0,3,0,0,9,4,3,3,3,0,0,13,22
3144,68212433,2682100,2682150,1243300,1243350,5,3,3,0,0,3,14,5,3,3,3,3,3,20,34
3145,68212448,2682100,2682150,1244800,1244850,0,3,3,0,3,3,12,3,3,0,3,3,3,15,27
3146,68222442,2682200,2682250,1244200,1244250,3,3,0,0,0,3,9,3,3,3,3,3,0,15,24
3147,68222447,2682200,2682250,1244700,1244750,0,0,0,0,0,0,0,0,0,3,0,0,0,3,3
3148,68222478,2682200,2682250,1247800,1247850,7,4,3,3,0,0,17,3,3,0,0,0,0,6,23
3149,68222467,2682200,2682250,1246700,1246750,3,3,0,3,0,0,9,3,3,0,3,0,0,9,18
3150,68222476,2682200,2682250,1247600,1247650,0,0,0,0,0,3,3,0,3,0,0,3,0,6,9
3151,68222430,2682200,2682250,1243000,1243050,3,0,3,3,0,0,9,3,3,3,0,3,3,15,24
3152,68232478,2682300,2682350,1247800,1247850,3,3,0,3,3,3,15,3,3,3,0,0,3,12,27
3153,68232438,2682300,2682350,1243800,1243850,3,3,3,3,3,3,18,3,3,4,0,6,3,19,37
3154,68232481,2682300,2682350,1248100,1248150,3,0,3,0,0,0,6,4,0,3,0,0,0,7,13
3155,68232457,2682300,2682350,1245700,1245750,3,3,0,3,0,3,12,0,3,3,0,3,0,9,21
3156,68232489,2682300,2682350,1248900,1248950,6,6,3,5,3,0,23,5,10,11,5,3,3,37,60
3157,68232446,2682300,2682350,1244600,1244650,3,3,3,3,3,0,15,3,4,3,3,3,0,16,31
3158,68232451,2682300,2682350,1245100,1245150,3,3,0,0,0,0,6,0,0,0,0,3,3,6,12
3159,68232468,2682300,2682350,1246800,1246850,0,0,0,0,3,0,3,0,0,3,0,3,0,6,9
3160,68232484,2682300,2682350,1248400,1248450,0,0,3,0,0,0,3,0,3,0,0,0,0,3,6
3161,68242436,2682400,2682450,1243600,1243650,3,0,0,3,3,0,9,3,3,3,3,0,3,15,24
3162,68242439,2682400,2682450,1243900,1243950,3,3,3,0,3,0,12,6,0,3,3,0,0,12,24
3163,68242493,2682400,2682450,1249300,1249350,6,7,3,3,3,0,22,3,3,3,3,3,3,18,40
3164,68242434,2682400,2682450,1243400,1243450,3,3,3,0,0,0,9,7,5,0,3,3,3,21,30
3165,68242453,2682400,2682450,1245300,1245350,3,3,3,0,0,0,9,3,3,4,3,0,0,13,22
3166,68242456,2682400,2682450,1245600,1245650,0,0,0,0,0,0,0,0,0,0,0,0,0,0,0
3167,68252441,2682500,2682550,1244100,1244150,0,3,3,0,0,0,6,3,3,3,0,3,0,12,18
3168,68252433,2682500,2682550,1243300,1243350,6,3,3,3,0,0,15,4,3,4,3,0,0,14,29
3169,68252431,2682500,2682550,1243100,1243150,0,3,3,0,0,0,6,5,4,3,3,3,0,18,24
3170,68252451,2682500,2682550,1245100,1245150,3,3,3,3,0,3,15,3,3,4,0,3,3,16,31
3171,68252501,2682500,2682550,1250100,1250150,4,3,3,0,0,0,10,3,0,0,0,3,0,6,16
3172,68252510,2682500,2682550,1251000,1251050,0,0,0,0,0,0,0,0,0,0,0,0,0,0,0
3173,68252503,2682500,2682550,1250300,1250350,3,3,0,0,0,0,6,0,0,3,0,0,0,3,9
3174,68252488,2682500,2682550,1248800,1248850,0,3,0,0,0,0,3,0,0,0,0,0,0,0,3
3175,68262496,2682600,2682650,1249600,1249650,3,3,3,3,0,0,12,4,3,3,3,0,0,13,25
3176,68262505,2682600,2682650,1250500,1250550,0,0,3,0,3,0,6,3,0,3,3,3,3,15,21
3177,68262503,2682600,2682650,1250300,1250350,3,3,3,0,0,0,9,0,3,3,0,0,0,6,15
3178,68272465,2682700,2682750,1246500,1246550,0,3,0,0,0,0,3,3,3,0,0,0,0,6,9
3179,68272446,2682700,2682750,1244600,1244650,0,0,0,0,0,0,0,3,0,0,0,0,0,3,3
3180,68272459,2682700,2682750,1245900,1245950,3,3,3,3,0,0,12,3,3,3,0,3,0,12,24
3181,68272482,2682700,2682750,1248200,1248250,3,0,0,0,0,0,3,0,0,0,0,0,0,0,3
3182,68282532,2682800,2682850,1253200,1253250,3,3,3,3,0,3,15,7,3,3,4,0,3,20,35
3183,68282440,2682800,2682850,1244000,1244050,3,3,3,0,0,0,9,3,3,3,0,3,3,15,24
3184,68282477,2682800,2682850,1247700,1247750,0,0,0,0,0,0,0,0,0,0,0,0,0,0,0
3185,68292430,2682900,2682950,1243000,1243050,3,3,3,3,3,3,18,3,3,3,3,3,3,18,36
3186,68292527,2682900,2682950,1252700,1252750,3,3,3,7,3,3,22,5,5,10,5,3,4,32,54
3187,68292531,2682900,2682950,1253100,1253150,3,3,3,3,0,0,12,4,3,3,3,3,0,16,28
3188,68292436,2682900,2682950,1243600,1243650,0,0,0,0,0,0,0,0,3,0,0,3,0,6,6
3189,68292497,2682900,2682950,1249700,1249750,0,3,0,0,0,0,3,3,0,3,0,0,0,6,9
3190,68292520,2682900,2682950,1252000,1252050,0,3,0,0,0,0,3,0,0,0,0,0,0,0,3
3191,68292456,2682900,2682950,1245600,1245650,0,0,0,0,0,0,0,0,0,0,0,0,0,0,0
3192,68292506,2682900,2682950,1250600,1250650,3,0,0,0,0,0,3,3,3,3,0,3,0,12,15
3193,68302490,2683000,2683050,1249000,1249050,3,3,3,5,3,4,21,4,4,4,16,20,40,88,109
3194,68302432,2683000,2683050,1243200,1243250,3,3,3,0,3,0,12,5,0,3,3,3,0,14,26
3195,68302496,2683000,2683050,1249600,1249650,0,3,3,0,0,0,6,5,3,4,0,3,3,18,24
3196,68312438,2683100,2683150,1243800,1243850,0,0,0,0,0,0,0,0,0,0,0,0,0,0,0
3197,68312509,2683100,2683150,1250900,1250950,3,0,0,0,0,0,3,3,3,3,0,3,0,12,15
3198,68312473,2683100,2683150,1247300,1247350,3,0,0,0,0,0,3,3,3,0,0,3,0,9,12
3199,68312501,2683100,2683150,1250100,1250150,3,3,3,3,0,0,12,3,8,0,3,0,0,14,26
3200,68312502,2683100,2683150,1250200,1250250,3,3,3,3,0,0,12,3,0,0,3,3,0,9,21
3201,68312536,2683100,2683150,1253600,1253650,3,0,3,3,3,0,12,3,4,8,3,3,0,21,33
3202,68312432,2683100,2683150,1243200,1243250,3,0,3,0,0,0,6,0,3,3,3,0,0,9,15
3203,68312508,2683100,2683150,1250800,1250850,3,0,3,0,0,0,6,3,0,3,0,0,0,6,12
3204,68322431,2683200,2683250,1243100,1243150,0,3,0,3,0,3,9,3,0,0,3,0,0,6,15
3205,68332539,2683300,2683350,1253900,1253950,3,3,3,0,0,0,9,3,3,3,3,0,0,12,21
3206,68332504,2683300,2683350,1250400,1250450,0,3,3,3,0,3,12,3,0,3,3,3,0,12,24
3207,68332510,2683300,2683350,1251000,1251050,3,3,0,3,0,0,9,3,5,3,0,0,3,14,23
3208,68332512,2683300,2683350,1251200,1251250,0,0,0,0,3,0,3,0,0,0,0,0,0,0,3
3209,68332520,2683300,2683350,1252000,1252050,3,0,0,0,0,0,3,0,0,0,0,0,0,0,3
3210,68342506,2683400,2683450,1250600,1250650,3,3,0,3,3,0,12,4,3,3,3,3,3,19,31
3211,68342531,2683400,2683450,1253100,1253150,3,3,3,3,0,0,12,3,3,3,3,0,0,12,24
3212,68342479,2683400,2683450,1247900,1247950,0,0,0,0,0,0,0,0,0,3,0,0,0,3,3
3213,68352472,2683500,2683550,1247200,1247250,3,3,3,3,3,3,18,3,3,0,0,0,0,6,24
3214,68352535,2683500,2683550,1253500,1253550,0,0,0,3,0,0,3,3,3,3,0,0,3,12,15
3215,68352486,2683500,2683550,1248600,1248650,3,0,4,0,0,0,7,3,3,3,3,3,0,15,22
3216,68352475,2683500,2683550,1247500,1247550,7,4,4,3,3,0,21,5,7,3,3,0,0,18,39
3217,68352507,2683500,2683550,1250700,1250750,4,3,3,0,0,0,10,6,0,0,3,3,0,12,22
3218,68352482,2683500,2683550,1248200,1248250,3,3,3,0,0,0,9,3,3,0,0,0,0,6,15
3219,68352495,2683500,2683550,1249500,1249550,3,0,3,3,0,0,9,0,3,3,3,3,0,12,21
3220,68352479,2683500,2683550,1247900,1247950,3,4,3,0,0,0,10,0,3,3,0,0,3,9,19
3221,68362527,2683600,2683650,1252700,1252750,3,3,3,0,3,0,12,3,0,3,3,0,0,9,21
3222,68372488,2683700,2683750,1248800,1248850,0,0,0,0,0,0,0,0,0,3,0,0,0,3,3
3223,68382488,2683800,2683850,1248800,1248850,3,0,3,0,0,3,9,3,3,0,3,0,0,9,18
3224,68382514,2683800,2683850,1251400,1251450,0,3,5,3,0,0,11,3,3,3,0,3,0,12,23
3225,68382460,2683800,2683850,1246000,1246050,3,0,3,0,0,0,6,3,0,0,3,0,0,6,12
3226,68392483,2683900,2683950,1248300,1248350,3,3,3,3,0,3,15,6,3,4,3,0,3,19,34
3227,68392461,2683900,2683950,1246100,1246150,5,3,3,3,0,0,14,3,3,3,3,0,0,12,26
3228,68392486,2683900,2683950,1248600,1248650,3,0,3,3,0,0,9,3,3,4,0,3,3,16,25
3229,68392522,2683900,2683950,1252200,1252250,3,0,0,0,0,0,3,0,3,0,0,0,0,3,6
3230,68392529,2683900,2683950,1252900,1252950,3,0,0,0,0,0,3,0,0,0,0,0,0,0,3
3231,68402524,2684000,2684050,1252400,1252450,0,0,3,0,0,0,3,0,3,0,0,0,0,3,6
3232,68402471,2684000,2684050,1247100,1247150,0,0,0,3,0,0,3,3,3,3,3,3,0,15,18
3233,68402506,2684000,2684050,1250600,1250650,0,0,0,0,0,0,0,0,0,0,0,0,0,0,0
3234,68402516,2684000,2684050,1251600,1251650,0,0,0,0,0,0,0,0,3,0,0,0,0,3,3
3235,68402515,2684000,2684050,1251500,1251550,0,0,3,3,0,0,6,0,3,3,3,3,0,12,18
3236,68412470,2684100,2684150,1247000,1247050,0,3,3,3,3,0,12,5,3,3,3,3,0,17,29
3237,68422512,2684200,2684250,1251200,1251250,0,0,0,0,0,0,0,0,0,0,0,0,0,0,0
3238,68422508,2684200,2684250,1250800,1250850,4,0,3,3,0,0,10,3,3,0,3,0,0,9,19
3239,68422485,2684200,2684250,1248500,1248550,3,0,0,3,0,0,6,3,0,3,0,3,0,9,15
3240,68422515,2684200,2684250,1251500,1251550,4,3,0,3,3,0,13,3,0,3,3,3,0,12,25
3241,68432469,2684300,2684350,1246900,1246950,4,3,3,3,0,0,13,4,0,3,3,3,0,13,26
3242,68432465,2684300,2684350,1246500,1246550,3,3,0,3,0,3,12,3,3,3,0,3,3,15,27
3243,68432508,2684300,2684350,1250800,1250850,0,3,0,0,0,0,3,0,0,0,0,0,3,3,6
3244,68432464,2684300,2684350,1246400,1246450,0,3,3,3,0,0,9,3,3,3,0,3,4,16,25
3245,68432525,2684300,2684350,1252500,1252550,3,5,4,0,0,0,12,7,4,0,3,3,0,17,29
3246,68432467,2684300,2684350,1246700,1246750,3,3,0,0,0,0,6,0,3,0,0,0,0,3,9
3247,68442485,2684400,2684450,1248500,1248550,3,4,3,3,0,0,13,3,3,0,3,3,3,15,28
3248,68442471,2684400,2684450,1247100,1247150,3,4,3,0,0,0,10,3,6,3,3,3,0,18,28
3249,68442521,2684400,2684450,1252100,1252150,3,0,0,0,0,0,3,3,3,0,0,3,0,9,12
3250,68442456,2684400,2684450,1245600,1245650,3,8,3,3,3,0,20,3,8,3,4,3,3,24,44
3251,68442509,2684400,2684450,1250900,1250950,0,0,3,0,0,0,3,0,3,3,3,3,3,15,18
3252,68452470,2684500,2684550,1247000,1247050,0,0,4,5,5,4,18,3,3,4,11,19,12,52,70
3253,68452516,2684500,2684550,1251600,1251650,3,3,3,3,3,3,18,0,5,3,4,3,0,15,33
3254,68472474,2684700,2684750,1247400,1247450,4,3,3,0,0,0,10,0,4,3,0,0,0,7,17
3255,68472467,2684700,2684750,1246700,1246750,3,5,3,3,0,3,17,3,5,3,3,0,0,14,31
3256,68472469,2684700,2684750,1246900,1246950,3,0,3,0,3,0,9,0,3,3,0,3,0,9,18
3257,68482473,2684800,2684850,1247300,1247350,3,0,3,0,0,0,6,0,3,4,0,0,3,10,16
3258,68482519,2684800,2684850,1251900,1251950,5,3,3,3,3,0,17,3,6,3,3,3,0,18,35
3259,68492478,2684900,2684950,1247800,1247850,3,0,3,3,0,3,12,3,3,3,3,3,0,15,27
3260,68492477,2684900,2684950,1247700,1247750,3,3,3,0,0,0,9,3,3,3,3,3,3,18,27
3261,68492486,2684900,2684950,1248600,1248650,0,0,0,0,3,0,3,0,0,3,0,0,0,3,6
3262,68492475,2684900,2684950,1247500,1247550,0,0,0,3,0,0,3,0,0,0,0,0,0,0,3
3263,68502464,2685000,2685050,1246400,1246450,7,3,3,3,3,0,19,6,4,3,3,3,0,19,38
3264,68502518,2685000,2685050,1251800,1251850,3,4,3,0,0,0,10,3,4,0,0,0,0,7,17
3265,68502483,2685000,2685050,1248300,1248350,0,0,0,0,3,0,3,3,0,0,0,0,0,3,6
3266,68512474,2685100,2685150,1247400,1247450,3,0,3,0,0,0,6,3,3,3,3,0,0,12,18
3267,68512475,2685100,2685150,1247500,1247550,3,3,3,3,3,0,15,3,3,3,0,0,0,9,24
3268,68512480,2685100,2685150,1248000,1248050,3,0,0,0,0,0,3,3,0,0,0,0,0,3,6
3269,68522474,2685200,2685250,1247400,1247450,3,0,0,0,0,0,3,3,0,3,3,0,0,9,12
3270,68532520,2685300,2685350,1252000,1252050,0,0,3,0,0,0,3,0,0,0,0,0,0,0,3
3271,68532476,2685300,2685350,1247600,1247650,0,0,0,0,0,0,0,0,0,0,0,0,0,0,0
3272,68542463,2685400,2685450,1246300,1246350,3,3,3,3,0,0,12,0,3,0,0,0,3,6,18
3273,68542512,2685400,2685450,1251200,1251250,3,3,3,3,3,0,15,3,3,0,3,3,3,15,30
3274,68542464,2685400,2685450,1246400,1246450,3,5,0,0,0,0,8,3,3,3,3,0,0,12,20
3275,68542520,2685400,2685450,1252000,1252050,0,0,0,0,0,0,0,0,0,0,0,0,0,0,0
3276,68542465,2685400,2685450,1246500,1246550,0,4,3,0,3,3,13,3,5,3,3,0,0,14,27
3277,68552479,2685500,2685550,1247900,1247950,0,3,0,0,0,0,3,0,0,0,0,0,0,0,3
3278,68552510,2685500,2685550,1251000,1251050,0,3,0,0,3,0,6,3,3,3,5,3,0,17,23
3279,68562515,2685600,2685650,1251500,1251550,0,0,0,0,0,3,3,0,3,0,0,0,0,3,6
3280,68562511,2685600,2685650,1251100,1251150,3,3,8,3,3,0,20,3,3,6,3,3,3,21,41
3281,68572448,2685700,2685750,1244800,1244850,0,0,3,3,0,0,6,3,0,3,3,3,3,15,21
3282,68592478,2685900,2685950,1247800,1247850,0,0,0,0,0,0,0,0,0,0,0,0,0,0,0
3283,68592461,2685900,2685950,1246100,1246150,0,3,4,0,0,0,7,0,3,4,0,0,3,10,17
3284,68592453,2685900,2685950,1245300,1245350,3,0,3,0,0,0,6,3,0,0,0,0,0,3,9
3285,68602509,2686000,2686050,1250900,1250950,5,0,3,3,0,0,11,3,3,3,3,0,3,15,26
3286,68602451,2686000,2686050,1245100,1245150,0,3,0,3,3,0,9,3,3,0,3,6,8,23,32
3287,68622512,2686200,2686250,1251200,1251250,3,6,3,3,3,3,21,3,3,3,3,0,0,12,33
3288,68632514,2686300,2686350,1251400,1251450,5,3,3,3,3,0,17,3,5,0,3,0,0,11,28
3289,68632511,2686300,2686350,1251100,1251150,3,3,0,0,0,0,6,0,0,3,3,0,0,6,12
3290,68632459,2686300,2686350,1245900,1245950,0,6,3,0,0,0,9,4,4,3,3,3,3,20,29
3291,68632458,2686300,2686350,1245800,1245850,3,0,0,0,0,0,3,0,0,3,3,0,0,6,9
3292,68642510,2686400,2686450,1251000,1251050,3,3,3,0,0,0,9,3,3,0,3,3,0,12,21
3293,68642504,2686400,2686450,1250400,1250450,6,3,3,3,3,3,21,3,3,3,4,5,3,21,42
3294,68662507,2686600,2686650,1250700,1250750,5,3,3,3,3,3,20,5,3,0,3,3,3,17,37
3295,68672455,2686700,2686750,1245500,1245550,0,3,3,3,3,0,12,3,3,3,0,3,0,12,24
3296,68672504,2686700,2686750,1250400,1250450,3,3,3,0,3,3,15,3,3,4,0,0,3,13,28
3297,68672461,2686700,2686750,1246100,1246150,3,3,0,4,3,0,13,0,3,5,4,5,3,20,33
3298,68682455,2686800,2686850,1245500,1245550,0,3,0,0,0,0,3,3,0,3,0,0,0,6,9
3299,68682509,2686800,2686850,1250900,1250950,3,0,0,0,0,0,3,0,0,0,0,0,0,0,3
3300,68692505,2686900,2686950,1250500,1250550,3,3,0,3,0,0,9,3,0,0,3,0,0,6,15
3301,68692476,2686900,2686950,1247600,1247650,0,0,0,0,0,0,0,0,0,0,0,0,0,0,0
3302,68702457,2687000,2687050,1245700,1245750,3,3,3,0,0,0,9,3,3,3,3,3,0,15,24
3303,68712501,2687100,2687150,1250100,1250150,3,0,0,0,0,3,6,0,0,0,0,0,0,0,6
3304,68742456,2687400,2687450,1245600,1245650,3,4,3,3,3,0,16,4,5,4,4,3,0,20,36
3305,68752459,2687500,2687550,1245900,1245950,3,3,3,3,3,0,15,3,4,5,3,4,3,22,37
3306,68772457,2687700,2687750,1245700,1245750,3,3,3,3,3,3,18,4,3,0,4,3,3,17,35
3307,67812493,2678100,2678150,1249300,1249350,3,3,3,0,0,3,12,6,3,3,3,0,0,15,27
3308,67822490,2678200,2678250,1249000,1249050,0,3,4,0,0,0,7,3,3,5,4,3,0,18,25
3309,67832493,2678300,2678350,1249300,1249350,5,3,3,0,0,0,11,3,3,0,3,3,3,15,26
3310,67842519,2678400,2678450,1251900,1251950,3,3,3,4,3,0,16,3,3,4,9,3,3,25,41
3311,67842495,2678400,2678450,1249500,1249550,0,0,3,0,0,0,3,0,3,3,0,0,0,6,9
3312,67852520,2678500,2678550,1252000,1252050,3,4,3,0,0,0,10,3,6,5,6,3,3,26,36
3313,67852489,2678500,2678550,1248900,1248950,4,6,3,3,3,0,19,6,6,4,5,3,3,27,46
3314,67862521,2678600,2678650,1252100,1252150,3,4,3,3,0,0,13,3,5,4,3,3,3,21,34
3315,67862519,2678600,2678650,1251900,1251950,3,3,3,0,0,0,9,3,3,3,3,5,3,20,29
3316,67862480,2678600,2678650,1248000,1248050,0,3,0,4,0,0,7,3,3,3,3,3,0,15,22
3317,67872488,2678700,2678750,1248800,1248850,3,3,4,3,0,3,16,0,0,7,3,3,0,13,29
3318,67882476,2678800,2678850,1247600,1247650,3,3,3,3,0,0,12,5,3,3,3,0,0,14,26
3319,67882501,2678800,2678850,1250100,1250150,6,5,7,5,4,4,31,8,8,6,7,3,0,32,63
3320,67882522,2678800,2678850,1252200,1252250,0,0,0,3,0,0,3,0,3,0,0,0,0,3,6
3321,67882492,2678800,2678850,1249200,1249250,3,3,3,0,0,0,9,3,0,3,3,3,3,15,24
3322,67882511,2678800,2678850,1251100,1251150,3,3,3,3,3,3,18,3,3,3,4,4,0,17,35
3323,67892481,2678900,2678950,1248100,1248150,0,3,0,0,0,0,3,3,3,0,3,0,0,9,12
3324,67892479,2678900,2678950,1247900,1247950,3,3,7,3,4,3,23,7,4,10,7,6,3,37,60
3325,67902475,2679000,2679050,1247500,1247550,0,3,3,3,0,0,9,3,5,3,0,3,0,14,23
3326,67902488,2679000,2679050,1248800,1248850,3,3,0,0,0,3,9,3,3,0,0,0,3,9,18
3327,67902486,2679000,2679050,1248600,1248650,3,3,3,3,0,0,12,0,3,3,3,3,3,15,27
3328,67902477,2679000,2679050,1247700,1247750,3,5,3,3,3,0,17,3,3,3,0,3,0,12,29
3329,67912486,2679100,2679150,1248600,1248650,3,5,3,3,3,3,20,5,3,3,4,3,0,18,38
3330,67912491,2679100,2679150,1249100,1249150,0,0,0,0,0,0,0,3,0,0,0,0,0,3,3
3331,67912514,2679100,2679150,1251400,1251450,0,0,3,0,0,0,3,0,3,0,0,0,0,3,6
3332,67922476,2679200,2679250,1247600,1247650,3,3,3,3,0,3,15,4,3,3,3,0,0,13,28
3333,67922475,2679200,2679250,1247500,1247550,3,3,0,0,0,0,6,0,3,3,3,0,3,12,18
3334,67922505,2679200,2679250,1250500,1250550,3,0,0,0,3,0,6,4,0,3,3,0,0,10,16
3335,67922497,2679200,2679250,1249700,1249750,0,0,0,0,0,0,0,0,0,0,0,0,0,0,0
3336,67932509,2679300,2679350,1250900,1250950,3,0,3,0,0,0,6,3,0,3,0,0,0,6,12
3337,67942493,2679400,2679450,1249300,1249350,3,4,3,3,3,3,19,3,4,0,3,0,3,13,32
3338,67942492,2679400,2679450,1249200,1249250,0,3,3,3,3,0,12,3,0,3,3,3,0,12,24
3339,67952478,2679500,2679550,1247800,1247850,3,3,3,3,0,0,12,3,3,0,3,3,0,12,24
3340,67952495,2679500,2679550,1249500,1249550,3,3,0,3,0,0,9,0,3,3,0,0,0,6,15
3341,67952492,2679500,2679550,1249200,1249250,3,0,3,0,0,0,6,0,3,3,0,0,0,6,12
3342,67962482,2679600,2679650,1248200,1248250,0,0,0,0,0,0,0,0,0,0,0,0,0,0,0
3343,67972481,2679700,2679750,1248100,1248150,3,0,0,0,0,0,3,3,0,0,0,0,0,3,6
3344,67982484,2679800,2679850,1248400,1248450,5,0,0,3,0,0,8,3,3,0,0,3,3,12,20
3345,67982467,2679800,2679850,1246700,1246750,0,0,0,0,0,0,0,0,0,0,0,0,0,0,0
3346,68002477,2680000,2680050,1247700,1247750,3,6,4,3,3,3,22,3,8,7,3,3,0,24,46
3347,68002488,2680000,2680050,1248800,1248850,5,3,0,0,0,0,8,3,5,3,3,3,0,17,25
3348,68002526,2680000,2680050,1252600,1252650,5,0,5,3,0,0,13,3,3,4,3,0,0,13,26
3349,68002473,2680000,2680050,1247300,1247350,3,3,3,0,3,0,12,0,3,3,3,0,3,12,24
3350,68002530,2680000,2680050,1253000,1253050,3,3,0,0,0,0,6,3,0,0,0,0,0,3,9
3351,68012527,2680100,2680150,1252700,1252750,3,0,3,0,0,0,6,3,3,0,3,0,3,12,18
3352,68012467,2680100,2680150,1246700,1246750,3,0,3,3,3,3,15,3,0,3,4,3,0,13,28
3353,68022473,2680200,2680250,1247300,1247350,6,12,6,5,3,3,35,8,13,13,11,6,3,54,89
3354,68022506,2680200,2680250,1250600,1250650,3,0,3,3,0,0,9,0,3,3,3,0,0,9,18
3355,68022466,2680200,2680250,1246600,1246650,5,0,0,3,3,0,11,3,3,3,0,0,0,9,20
3356,68032489,2680300,2680350,1248900,1248950,3,0,0,0,0,0,3,3,0,3,0,0,0,6,9
3357,68032480,2680300,2680350,1248000,1248050,5,4,3,3,0,0,15,5,4,3,3,3,0,18,33
3358,68032472,2680300,2680350,1247200,1247250,3,3,3,3,3,0,15,3,3,3,3,3,0,15,30
3359,68032530,2680300,2680350,1253000,1253050,4,4,3,3,3,0,17,5,5,3,3,3,0,19,36
3360,68042465,2680400,2680450,1246500,1246550,0,0,0,0,0,0,0,0,0,0,0,0,0,0,0
3361,68042476,2680400,2680450,1247600,1247650,0,3,3,3,0,0,9,0,0,0,3,0,0,3,12
3362,68042528,2680400,2680450,1252800,1252850,6,5,3,3,0,0,17,7,4,3,3,0,0,17,34
3363,68042463,2680400,2680450,1246300,1246350,4,3,3,0,0,0,10,0,4,0,0,0,0,4,14
3364,68052522,2680500,2680550,1252200,1252250,3,3,3,3,0,0,12,3,3,0,3,3,0,12,24
3365,68052531,2680500,2680550,1253100,1253150,0,3,0,0,3,0,6,0,3,0,0,0,0,3,9
3366,68052483,2680500,2680550,1248300,1248350,3,3,3,3,0,0,12,3,4,0,0,0,0,7,19
3367,68062500,2680600,2680650,1250000,1250050,3,3,0,3,0,0,9,3,0,3,3,3,3,15,24
3368,68062525,2680600,2680650,1252500,1252550,3,3,3,0,3,3,15,3,3,0,0,4,0,10,25
3369,68062504,2680600,2680650,1250400,1250450,3,3,3,3,0,0,12,3,3,3,3,0,0,12,24
3370,68062498,2680600,2680650,1249800,1249850,3,3,3,0,3,0,12,3,0,0,0,3,0,6,18
3371,68072501,2680700,2680750,1250100,1250150,3,3,0,0,0,0,6,3,3,0,3,0,0,9,15
3372,68072505,2680700,2680750,1250500,1250550,3,4,3,4,3,0,17,4,3,6,5,3,0,21,38
3373,68072507,2680700,2680750,1250700,1250750,0,0,0,0,0,0,0,0,0,0,0,0,0,0,0
3374,68082520,2680800,2680850,1252000,1252050,0,0,3,3,0,0,6,3,3,3,0,0,0,9,15
3375,68082460,2680800,2680850,1246000,1246050,3,3,3,3,3,3,18,3,5,4,3,3,3,21,39
3376,68082481,2680800,2680850,1248100,1248150,0,0,0,0,0,0,0,0,0,0,0,0,0,0,0
3377,68082528,2680800,2680850,1252800,1252850,0,0,0,3,0,0,3,0,0,3,0,0,0,3,6
3378,68092495,2680900,2680950,1249500,1249550,3,0,0,0,0,0,3,3,0,0,0,0,0,3,6
3379,68092531,2680900,2680950,1253100,1253150,3,5,3,3,3,0,17,3,4,3,4,3,0,17,34
3380,68092420,2680900,2680950,1242000,1242050,3,3,0,3,0,0,9,4,3,3,0,0,0,10,19
3381,68102471,2681000,2681050,1247100,1247150,3,7,4,3,0,0,17,4,3,8,0,0,0,15,32
3382,68102459,2681000,2681050,1245900,1245950,0,0,0,0,0,0,0,0,0,0,0,0,0,0,0
3383,68102499,2681000,2681050,1249900,1249950,3,3,3,0,0,0,9,3,3,3,3,3,3,18,27
3384,68102520,2681000,2681050,1252000,1252050,3,3,3,0,0,0,9,0,3,0,0,3,0,6,15
3385,68102486,2681000,2681050,1248600,1248650,3,0,3,3,0,0,9,4,3,0,0,0,3,10,19
3386,68102460,2681000,2681050,1246000,1246050,0,3,0,0,0,3,6,3,3,0,0,0,0,6,12
3387,68112470,2681100,2681150,1247000,1247050,3,4,5,3,3,0,18,4,3,4,3,3,3,20,38
3388,68112427,2681100,2681150,1242700,1242750,0,3,4,0,3,0,10,3,3,3,0,3,0,12,22
3389,68122479,2681200,2681250,1247900,1247950,5,3,3,3,0,0,14,9,5,8,3,3,0,28,42
3390,68122519,2681200,2681250,1251900,1251950,3,3,0,0,0,0,6,3,4,0,0,3,3,13,19
3391,68122470,2681200,2681250,1247000,1247050,3,3,0,0,0,0,6,0,3,0,3,0,0,6,12
3392,68122481,2681200,2681250,1248100,1248150,3,3,0,0,0,0,6,4,0,0,0,0,3,7,13
3393,68122483,2681200,2681250,1248300,1248350,0,0,0,0,0,0,0,0,0,0,0,0,0,0,0
3394,68132422,2681300,2681350,1242200,1242250,9,16,5,4,6,7,47,13,7,11,12,28,28,99,146
3395,68132473,2681300,2681350,1247300,1247350,3,3,0,0,0,0,6,3,3,3,0,3,0,12,18
3396,68132521,2681300,2681350,1252100,1252150,3,3,0,3,0,3,12,0,3,3,0,3,0,9,21
3397,68132522,2681300,2681350,1252200,1252250,3,0,3,0,3,3,12,0,3,3,3,3,3,15,27
3398,68132457,2681300,2681350,1245700,1245750,3,0,0,0,0,0,3,0,3,0,0,0,0,3,6
3399,68132482,2681300,2681350,1248200,1248250,3,3,3,3,0,0,12,3,4,3,3,0,0,13,25
3400,68142427,2681400,2681450,1242700,1242750,4,0,3,3,0,0,10,3,3,0,3,0,0,9,19
3401,68142518,2681400,2681450,1251800,1251850,0,0,0,0,0,0,0,3,3,0,0,3,0,9,9
3402,68142458,2681400,2681450,1245800,1245850,3,3,3,3,0,0,12,3,3,3,3,0,0,12,24
3403,68142465,2681400,2681450,1246500,1246550,3,3,3,3,0,0,12,4,3,3,0,3,0,13,25
3404,68142520,2681400,2681450,1252000,1252050,3,0,3,3,3,0,12,3,3,0,3,3,0,12,24
3405,68142433,2681400,2681450,1243300,1243350,6,0,3,3,3,3,18,3,3,3,3,3,0,15,33
3406,68142429,2681400,2681450,1242900,1242950,0,0,3,0,0,0,3,0,3,0,0,0,0,3,6
3407,68142497,2681400,2681450,1249700,1249750,3,3,0,0,0,0,6,3,3,3,0,3,0,12,18
3408,68142421,2681400,2681450,1242100,1242150,0,0,0,0,0,0,0,0,0,3,0,0,0,3,3
3409,68152469,2681500,2681550,1246900,1246950,3,3,0,3,0,0,9,3,0,3,3,0,0,9,18
3410,68152492,2681500,2681550,1249200,1249250,3,3,0,3,0,0,9,3,0,0,0,0,0,3,12
3411,68162422,2681600,2681650,1242200,1242250,3,0,0,0,3,0,6,3,0,0,3,0,0,6,12
3412,68162435,2681600,2681650,1243500,1243550,3,0,0,0,0,0,3,3,3,3,0,0,0,9,12
3413,68172497,2681700,2681750,1249700,1249750,3,0,4,3,0,0,10,5,3,4,3,3,0,18,28
3414,68172460,2681700,2681750,1246000,1246050,7,3,3,3,0,0,16,4,3,3,0,0,0,10,26
3415,68172531,2681700,2681750,1253100,1253150,3,0,3,3,3,0,12,3,3,0,0,0,0,6,18
3416,68172471,2681700,2681750,1247100,1247150,3,0,3,3,0,0,9,3,3,0,3,3,0,12,21
3417,68172444,2681700,2681750,1244400,1244450,0,0,0,0,0,0,0,0,0,0,0,0,0,0,0
3418,68182478,2681800,2681850,1247800,1247850,8,4,0,4,0,0,16,10,4,4,3,3,3,27,43
3419,68182502,2681800,2681850,1250200,1250250,3,0,3,0,0,3,9,3,4,0,3,0,0,10,19
3420,68182442,2681800,2681850,1244200,1244250,0,0,0,0,0,0,0,3,3,0,0,0,0,6,6
3421,68192532,2681900,2681950,1253200,1253250,3,0,0,3,0,0,6,3,3,0,3,0,0,9,15
3422,68192492,2681900,2681950,1249200,1249250,0,0,0,0,0,0,0,0,3,0,0,0,0,3,3
3423,68192439,2681900,2681950,1243900,1243950,0,0,0,0,0,0,0,0,0,0,0,0,0,0,0
3424,68202514,2682000,2682050,1251400,1251450,0,3,3,3,3,3,15,0,3,3,3,3,3,15,30
3425,68202478,2682000,2682050,1247800,1247850,3,3,0,0,0,0,6,3,0,0,0,3,0,6,12
3426,68202440,2682000,2682050,1244000,1244050,0,3,3,3,3,0,12,5,0,3,3,3,0,14,26
3427,68202446,2682000,2682050,1244600,1244650,3,3,3,0,0,0,9,3,4,3,0,3,0,13,22
3428,68202513,2682000,2682050,1251300,1251350,0,0,0,0,0,0,0,0,0,3,3,0,0,6,6
3429,68202512,2682000,2682050,1251200,1251250,0,0,0,0,3,0,3,0,0,4,0,3,0,7,10
3430,67982445,2679800,2679850,1244500,1244550,0,3,0,0,0,0,3,0,0,0,0,0,0,0,3
3431,68122496,2681200,2681250,1249600,1249650,3,3,0,0,0,0,6,3,0,3,0,0,0,6,12
3432,68052475,2680500,2680550,1247500,1247550,0,3,0,0,3,0,6,3,0,0,0,0,0,3,9
3433,67782494,2677800,2677850,1249400,1249450,3,6,8,8,5,3,33,4,10,13,4,14,3,48,81
3434,67792496,2677900,2677950,1249600,1249650,4,4,3,3,0,0,14,3,3,0,3,0,0,9,23
3435,67802494,2678000,2678050,1249400,1249450,3,3,3,3,0,0,12,3,4,3,3,3,0,16,28
3436,67802497,2678000,2678050,1249700,1249750,3,3,0,3,0,0,9,3,3,3,0,0,0,9,18
3437,67802489,2678000,2678050,1248900,1248950,3,3,3,3,0,0,12,3,3,0,0,3,0,9,21
3438,67812496,2678100,2678150,1249600,1249650,4,3,3,3,0,0,13,7,3,3,3,0,0,16,29
3439,67812484,2678100,2678150,1248400,1248450,0,3,0,3,0,0,6,0,0,3,0,0,0,3,9
3440,67822488,2678200,2678250,1248800,1248850,3,0,0,3,0,0,6,4,3,3,3,3,3,19,25
3441,67822521,2678200,2678250,1252100,1252150,3,0,3,0,0,0,6,0,3,0,3,0,0,6,12
3442,67832518,2678300,2678350,1251800,1251850,3,0,3,0,0,3,9,3,3,3,3,3,3,18,27
3443,67842522,2678400,2678450,1252200,1252250,3,0,3,0,0,0,6,3,0,0,3,0,0,6,12
3444,67852514,2678500,2678550,1251400,1251450,0,0,0,0,0,0,0,0,0,0,0,0,0,0,0
3445,67852487,2678500,2678550,1248700,1248750,4,3,4,3,3,0,17,4,3,3,3,3,3,19,36
3446,67862484,2678600,2678650,1248400,1248450,4,3,3,0,3,0,13,4,3,3,3,0,0,13,26
3447,67862493,2678600,2678650,1249300,1249350,4,3,3,3,0,0,13,3,3,3,0,3,3,15,28
3448,67862490,2678600,2678650,1249000,1249050,5,3,4,3,3,0,18,3,3,3,3,3,0,15,33
3449,67862496,2678600,2678650,1249600,1249650,3,0,0,0,0,0,3,0,0,3,0,0,0,3,6
3450,67862492,2678600,2678650,1249200,1249250,5,0,3,3,0,0,11,4,0,3,3,3,0,13,24
3451,67872477,2678700,2678750,1247700,1247750,3,3,3,3,3,0,15,3,3,3,4,3,3,19,34
3452,67872493,2678700,2678750,1249300,1249350,3,3,0,0,0,0,6,3,0,0,0,0,0,3,9
3453,67872480,2678700,2678750,1248000,1248050,3,0,3,0,0,0,6,0,3,0,3,0,0,6,12
3454,67872510,2678700,2678750,1251000,1251050,3,3,3,0,3,3,15,3,3,4,3,5,3,21,36
3455,67882487,2678800,2678850,1248700,1248750,4,5,3,3,3,0,18,9,5,3,6,6,3,32,50
3456,67882491,2678800,2678850,1249100,1249150,3,0,0,0,0,0,3,3,3,3,3,3,0,15,18
3457,67882500,2678800,2678850,1250000,1250050,9,5,5,0,0,0,19,11,6,3,3,3,0,26,45
3458,67892480,2678900,2678950,1248000,1248050,0,5,3,3,3,0,14,6,5,3,4,3,3,24,38
3459,67892494,2678900,2678950,1249400,1249450,3,3,3,0,0,3,12,5,4,4,0,0,0,13,25
3460,67902474,2679000,2679050,1247400,1247450,3,3,3,0,3,0,12,3,0,3,3,3,0,12,24
3461,67912506,2679100,2679150,1250600,1250650,0,3,0,3,3,0,9,0,3,0,4,0,0,7,16
3462,67912498,2679100,2679150,1249800,1249850,3,0,3,3,0,0,9,3,3,3,0,0,0,9,18
3463,67922485,2679200,2679250,1248500,1248550,0,3,3,3,3,3,15,3,5,3,4,3,0,18,33
3464,67922507,2679200,2679250,1250700,1250750,3,0,3,0,3,0,9,3,3,3,0,0,0,9,18
3465,67922486,2679200,2679250,1248600,1248650,3,3,0,0,0,0,6,3,3,0,0,3,0,9,15
3466,67932491,2679300,2679350,1249100,1249150,4,4,3,3,0,0,14,7,3,3,3,0,0,16,30
3467,67932507,2679300,2679350,1250700,1250750,3,3,3,3,3,0,15,3,3,3,3,0,0,12,27
3468,67932473,2679300,2679350,1247300,1247350,3,0,3,3,0,3,12,3,3,3,3,0,3,15,27
3469,67932475,2679300,2679350,1247500,1247550,0,3,0,0,0,0,3,3,3,0,0,3,0,9,12
3470,67942482,2679400,2679450,1248200,1248250,0,0,0,0,0,0,0,3,0,0,0,0,0,3,3
3471,67942501,2679400,2679450,1250100,1250150,3,3,3,3,3,0,15,3,3,3,3,3,3,18,33
3472,67942471,2679400,2679450,1247100,1247150,3,0,0,3,0,0,6,3,3,3,0,3,3,15,21
3473,67952472,2679500,2679550,1247200,1247250,3,3,3,0,3,3,15,4,6,3,3,3,3,22,37
3474,67952479,2679500,2679550,1247900,1247950,3,4,3,3,3,0,16,3,3,3,3,0,0,12,28
3475,67952500,2679500,2679550,1250000,1250050,8,3,9,0,4,0,24,6,4,5,4,3,3,25,49
3476,67962466,2679600,2679650,1246600,1246650,3,0,0,3,0,3,9,3,3,3,3,3,3,18,27
3477,67962507,2679600,2679650,1250700,1250750,3,3,3,0,0,0,9,3,3,3,3,3,0,15,24
3478,67962531,2679600,2679650,1253100,1253150,3,3,3,3,0,0,12,4,3,3,3,3,3,19,31
3479,67972510,2679700,2679750,1251000,1251050,4,5,3,3,0,3,18,4,6,3,0,3,3,19,37
3480,67972476,2679700,2679750,1247600,1247650,3,3,3,3,3,0,15,4,4,3,3,0,3,17,32
3481,67972509,2679700,2679750,1250900,1250950,3,4,3,3,0,0,13,4,5,3,3,0,0,15,28
3482,67972472,2679700,2679750,1247200,1247250,3,4,3,4,0,3,17,3,3,3,3,3,5,20,37
3483,67972487,2679700,2679750,1248700,1248750,0,0,3,0,0,0,3,0,3,3,0,0,0,6,9
3484,67982529,2679800,2679850,1252900,1252950,4,4,7,6,0,3,24,3,6,5,8,8,0,30,54
3485,67982475,2679800,2679850,1247500,1247550,3,3,3,0,0,0,9,3,3,0,3,0,3,12,21
3486,67992477,2679900,2679950,1247700,1247750,0,0,3,0,0,0,3,0,0,0,0,0,0,0,3
3487,67992478,2679900,2679950,1247800,1247850,3,3,3,0,0,0,9,3,0,0,3,0,0,6,15
3488,67992528,2679900,2679950,1252800,1252850,3,3,3,3,3,3,18,3,3,3,0,0,3,12,30
3489,67992489,2679900,2679950,1248900,1248950,0,0,0,0,3,0,3,0,0,3,3,0,0,6,9
3490,68002484,2680000,2680050,1248400,1248450,3,3,4,4,0,3,17,5,3,4,3,3,0,18,35
3491,68002487,2680000,2680050,1248700,1248750,3,0,3,0,3,0,9,3,0,3,3,3,3,15,24
3492,68002510,2680000,2680050,1251000,1251050,4,3,3,3,3,0,16,3,3,7,3,0,3,19,35
3493,68002470,2680000,2680050,1247000,1247050,0,3,3,3,0,7,16,0,0,3,10,15,21,49,65
3494,68012504,2680100,2680150,1250400,1250450,3,3,6,3,3,3,21,3,3,3,3,3,0,15,36
3495,68022508,2680200,2680250,1250800,1250850,3,0,3,3,3,3,15,3,5,4,4,3,3,22,37
3496,68022486,2680200,2680250,1248600,1248650,3,3,5,3,3,3,20,4,5,4,4,3,3,23,43
3497,68022530,2680200,2680250,1253000,1253050,4,3,3,0,0,0,10,3,3,3,3,3,3,18,28
3498,68022510,2680200,2680250,1251000,1251050,0,0,0,0,0,3,3,0,0,0,0,0,0,0,3
3499,68022462,2680200,2680250,1246200,1246250,7,6,8,4,3,0,28,9,12,13,6,3,3,46,74
3500,68032525,2680300,2680350,1252500,1252550,3,3,3,3,0,0,12,3,0,3,3,0,3,12,24
3501,68032528,2680300,2680350,1252800,1252850,3,3,3,3,0,0,12,3,4,3,3,3,0,16,28
3502,68042531,2680400,2680450,1253100,1253150,3,3,3,0,3,0,12,3,3,3,0,0,0,9,21
3503,68042466,2680400,2680450,1246600,1246650,0,3,0,0,0,0,3,0,0,0,0,0,0,0,3
3504,68042532,2680400,2680450,1253200,1253250,0,0,0,0,0,0,0,0,0,0,3,0,0,3,3
3505,68052512,2680500,2680550,1251200,1251250,0,0,0,0,0,0,0,0,0,0,0,0,0,0,0
3506,68052505,2680500,2680550,1250500,1250550,3,0,3,3,3,0,12,3,3,3,3,0,0,12,24
3507,68062461,2680600,2680650,1246100,1246150,3,3,0,0,0,0,6,0,3,3,3,3,4,16,22
3508,68062473,2680600,2680650,1247300,1247350,3,4,3,3,3,0,16,4,3,4,3,0,0,14,30
3509,68062455,2680600,2680650,1245500,1245550,3,0,0,0,0,3,6,3,0,3,0,0,0,6,12
3510,68072469,2680700,2680750,1246900,1246950,3,3,3,0,3,0,12,5,0,3,3,3,0,14,26
3511,68072482,2680700,2680750,1248200,1248250,3,3,3,0,0,0,9,0,0,3,0,0,0,3,12
3512,68072496,2680700,2680750,1249600,1249650,3,4,3,0,0,0,10,7,3,3,0,0,0,13,23
3513,68082504,2680800,2680850,1250400,1250450,8,4,3,3,0,0,18,3,6,3,3,0,0,15,33
3514,68082531,2680800,2680850,1253100,1253150,5,0,3,4,0,0,12,3,3,3,3,3,0,15,27
3515,68092485,2680900,2680950,1248500,1248550,3,3,3,0,0,0,9,3,3,0,0,3,0,9,18
3516,68092483,2680900,2680950,1248300,1248350,6,10,11,9,3,3,42,11,7,8,17,21,23,87,129
3517,68102497,2681000,2681050,1249700,1249750,0,0,0,0,0,0,0,0,0,0,0,0,0,0,0
3518,68102498,2681000,2681050,1249800,1249850,3,5,3,0,0,0,11,7,4,3,0,3,0,17,28
3519,68102480,2681000,2681050,1248000,1248050,3,4,0,3,3,0,13,3,0,3,3,0,3,12,25
3520,68112472,2681100,2681150,1247200,1247250,5,3,3,3,4,0,18,4,6,11,3,3,0,27,45
3521,68112476,2681100,2681150,1247600,1247650,3,3,3,0,0,0,9,3,3,0,0,0,0,6,15
3522,68112420,2681100,2681150,1242000,1242050,0,3,0,0,3,0,6,0,3,3,0,3,0,9,15
3523,68112456,2681100,2681150,1245600,1245650,5,0,3,3,3,3,17,3,3,3,3,3,0,15,32
3524,68112531,2681100,2681150,1253100,1253150,3,3,0,0,0,0,6,3,3,3,3,3,3,18,24
3525,68112478,2681100,2681150,1247800,1247850,3,3,0,0,0,0,6,5,3,3,0,0,0,11,17
3526,68122459,2681200,2681250,1245900,1245950,3,3,3,0,3,0,12,0,3,3,3,0,0,9,21
3527,68122477,2681200,2681250,1247700,1247750,6,7,3,0,0,3,19,10,3,0,3,0,3,19,38
3528,68122460,2681200,2681250,1246000,1246050,0,3,3,3,0,0,9,3,3,0,3,0,0,9,18
3529,68122467,2681200,2681250,1246700,1246750,3,0,3,0,0,0,6,3,3,0,3,0,0,9,15
3530,68122429,2681200,2681250,1242900,1242950,0,0,0,0,0,0,0,3,0,0,0,0,0,3,3
3531,68122432,2681200,2681250,1243200,1243250,3,0,0,0,0,0,3,3,0,0,0,0,0,3,6
3532,68132469,2681300,2681350,1246900,1246950,3,3,0,0,0,0,6,3,3,3,3,0,0,12,18
3533,68132497,2681300,2681350,1249700,1249750,4,3,3,0,0,3,13,3,6,3,0,3,3,18,31
3534,68132429,2681300,2681350,1242900,1242950,0,0,0,0,0,3,3,0,0,0,3,0,0,3,6
3535,68132474,2681300,2681350,1247400,1247450,3,3,3,3,3,0,15,3,0,3,0,3,0,9,24
3536,68132520,2681300,2681350,1252000,1252050,3,6,3,3,0,0,15,5,3,5,0,0,0,13,28
3537,68132489,2681300,2681350,1248900,1248950,0,0,0,0,0,0,0,0,0,0,0,0,0,0,0
3538,68132523,2681300,2681350,1252300,1252350,0,0,0,0,0,0,0,0,0,0,0,0,0,0,0
3539,68142431,2681400,2681450,1243100,1243150,0,4,3,0,0,0,7,3,0,3,0,0,3,9,16
3540,68142437,2681400,2681450,1243700,1243750,3,0,0,0,0,0,3,3,0,0,0,0,0,3,6
3541,68142502,2681400,2681450,1250200,1250250,0,0,0,3,3,3,9,3,3,3,4,0,0,13,22
3542,68142456,2681400,2681450,1245600,1245650,0,0,0,0,0,0,0,3,0,0,0,3,0,6,6
3543,68142422,2681400,2681450,1242200,1242250,3,0,3,3,3,0,12,3,3,3,3,3,0,15,27
3544,68152465,2681500,2681550,1246500,1246550,3,3,3,0,0,3,12,3,3,3,3,0,3,15,27
3545,68152459,2681500,2681550,1245900,1245950,3,3,3,0,0,0,9,3,3,3,0,0,0,9,18
3546,68152474,2681500,2681550,1247400,1247450,3,3,3,0,3,0,12,3,3,3,0,3,0,12,24
3547,68152499,2681500,2681550,1249900,1249950,0,3,0,3,0,0,6,3,3,3,0,0,0,9,15
3548,68152473,2681500,2681550,1247300,1247350,3,3,3,3,3,0,15,6,4,3,0,0,0,13,28
3549,68172520,2681700,2681750,1252000,1252050,0,0,0,0,0,3,3,3,3,0,3,0,0,9,12
3550,68172438,2681700,2681750,1243800,1243850,0,0,3,0,0,0,3,0,0,0,3,0,0,3,6
3551,68182467,2681800,2681850,1246700,1246750,3,3,3,0,0,0,9,3,3,0,0,0,0,6,15
3552,68182497,2681800,2681850,1249700,1249750,3,0,0,3,3,0,9,3,3,3,0,4,3,16,25
3553,68182531,2681800,2681850,1253100,1253150,3,6,3,4,3,3,22,5,5,3,4,3,3,23,45
3554,68182474,2681800,2681850,1247400,1247450,0,3,3,0,0,0,6,3,3,3,3,3,0,15,21
3555,68192441,2681900,2681950,1244100,1244150,3,3,3,3,0,0,12,3,3,3,0,3,0,12,24
3556,68702459,2687000,2687050,1245900,1245950,0,0,0,0,0,0,0,3,0,0,0,0,0,3,3
3557,68712459,2687100,2687150,1245900,1245950,3,3,3,0,0,0,9,3,3,3,3,3,0,15,24
3558,68722503,2687200,2687250,1250300,1250350,4,3,3,3,0,0,13,5,3,3,3,3,0,17,30
3559,68722455,2687200,2687250,1245500,1245550,0,0,3,0,3,0,6,3,0,0,3,0,0,6,12
3560,68732457,2687300,2687350,1245700,1245750,0,0,3,0,3,0,6,0,3,3,3,3,0,12,18
3561,68752463,2687500,2687550,1246300,1246350,0,0,0,0,0,0,0,0,0,0,0,0,3,3,3
3562,68782461,2687800,2687850,1246100,1246150,3,3,3,0,3,0,12,3,3,3,3,3,3,18,30
3563,68212515,2682100,2682150,1251500,1251550,0,3,0,3,0,0,6,3,3,3,3,3,0,15,21
3564,68212496,2682100,2682150,1249600,1249650,3,3,3,0,3,0,12,5,3,5,0,0,3,16,28
3565,68212440,2682100,2682150,1244000,1244050,3,3,3,3,0,0,12,3,3,4,0,3,3,16,28
3566,68212454,2682100,2682150,1245400,1245450,3,5,3,3,0,3,17,4,3,4,0,0,3,14,31
3567,68212464,2682100,2682150,1246400,1246450,3,3,3,0,0,0,9,3,0,4,0,0,0,7,16
3568,68212437,2682100,2682150,1243700,1243750,3,3,3,3,0,0,12,3,3,3,3,3,0,15,27
3569,68212444,2682100,2682150,1244400,1244450,3,0,3,3,0,0,9,3,0,0,0,3,0,6,15
3570,68212452,2682100,2682150,1245200,1245250,0,0,0,0,0,0,0,0,0,3,0,0,0,3,3
3571,68212473,2682100,2682150,1247300,1247350,3,0,0,0,0,0,3,3,0,3,0,0,3,9,12
3572,68212443,2682100,2682150,1244300,1244350,0,0,3,3,0,0,6,0,3,0,3,0,0,6,12
3573,68222499,2682200,2682250,1249900,1249950,3,3,3,3,3,3,18,3,3,3,3,3,0,15,33
3574,68222464,2682200,2682250,1246400,1246450,3,0,0,0,0,3,6,3,3,3,0,0,0,9,15
3575,68222488,2682200,2682250,1248800,1248850,3,3,0,0,3,0,9,3,3,3,3,0,3,15,24
3576,68222502,2682200,2682250,1250200,1250250,3,0,3,0,0,0,6,0,3,3,0,0,0,6,12
3577,68222494,2682200,2682250,1249400,1249450,3,0,0,0,0,0,3,3,3,0,3,3,0,12,15
3578,68222453,2682200,2682250,1245300,1245350,3,0,3,0,0,0,6,3,3,3,0,0,3,12,18
3579,68222523,2682200,2682250,1252300,1252350,3,0,3,0,0,0,6,3,0,3,0,0,0,6,12
3580,68242480,2682400,2682450,1248000,1248050,3,0,0,0,0,3,6,3,3,0,0,0,0,6,12
3581,68242499,2682400,2682450,1249900,1249950,4,3,3,0,0,0,10,3,3,3,0,0,3,12,22
3582,68242475,2682400,2682450,1247500,1247550,0,3,3,0,3,0,9,0,3,3,3,0,0,9,18
3583,68242519,2682400,2682450,1251900,1251950,3,3,3,0,0,0,9,0,3,3,0,3,0,9,18
3584,68242509,2682400,2682450,1250900,1250950,0,0,0,0,0,0,0,0,0,0,0,0,0,0,0
3585,68252455,2682500,2682550,1245500,1245550,3,3,3,3,0,0,12,5,3,4,4,3,0,19,31
3586,68252471,2682500,2682550,1247100,1247150,10,3,3,4,0,0,20,7,6,3,3,0,3,22,42
3587,68252505,2682500,2682550,1250500,1250550,3,3,3,3,0,0,12,3,3,0,0,0,0,6,18
3588,68262487,2682600,2682650,1248700,1248750,0,0,0,3,0,0,3,0,3,0,0,0,0,3,6
3589,68262491,2682600,2682650,1249100,1249150,3,3,0,0,0,0,6,6,5,0,3,0,0,14,20
3590,68262460,2682600,2682650,1246000,1246050,3,3,3,0,0,3,12,3,0,3,3,3,0,12,24
3591,68262437,2682600,2682650,1243700,1243750,3,0,3,3,0,0,9,3,3,3,3,3,0,15,24
3592,68262457,2682600,2682650,1245700,1245750,0,0,3,0,0,0,3,0,3,0,0,0,0,3,6
3593,68262463,2682600,2682650,1246300,1246350,0,3,3,0,0,0,6,3,3,4,0,3,3,16,22
3594,68262465,2682600,2682650,1246500,1246550,0,3,3,3,3,0,12,3,5,3,0,3,0,14,26
3595,68262479,2682600,2682650,1247900,1247950,3,3,0,0,0,0,6,0,3,3,0,0,0,6,12
3596,68262493,2682600,2682650,1249300,1249350,3,3,3,3,0,0,12,3,3,3,0,3,0,12,24
3597,68262508,2682600,2682650,1250800,1250850,3,0,0,0,0,0,3,3,0,0,0,3,0,6,9
3598,68272463,2682700,2682750,1246300,1246350,0,0,0,0,0,0,0,0,0,3,0,0,0,3,3
3599,68272534,2682700,2682750,1253400,1253450,3,3,0,0,0,0,6,3,0,0,0,0,0,3,9
3600,68282498,2682800,2682850,1249800,1249850,6,3,3,3,3,0,18,3,6,4,0,0,3,16,34
3601,68282497,2682800,2682850,1249700,1249750,0,3,3,0,0,0,6,3,3,3,0,3,0,12,18
3602,68282537,2682800,2682850,1253700,1253750,3,0,0,0,0,0,3,3,0,0,0,3,0,6,9
3603,68282465,2682800,2682850,1246500,1246550,0,3,3,0,3,0,9,3,3,3,3,0,0,12,21
3604,68282522,2682800,2682850,1252200,1252250,0,3,0,0,0,0,3,3,3,3,0,0,0,9,12
3605,68292499,2682900,2682950,1249900,1249950,3,3,3,3,3,3,18,3,6,3,3,5,3,23,41
3606,68292535,2682900,2682950,1253500,1253550,4,3,3,0,0,0,10,3,3,3,0,3,3,15,25
3607,68292505,2682900,2682950,1250500,1250550,3,7,3,0,0,0,13,3,3,3,3,3,0,15,28
3608,68292483,2682900,2682950,1248300,1248350,3,3,0,0,0,0,6,0,0,3,0,0,0,3,9
3609,68292509,2682900,2682950,1250900,1250950,0,0,0,0,0,0,0,0,3,3,0,0,0,6,6
3610,68292504,2682900,2682950,1250400,1250450,3,0,0,0,3,0,6,0,0,4,3,0,0,7,13
3611,68292496,2682900,2682950,1249600,1249650,3,7,9,3,3,3,28,9,9,7,6,10,3,44,72
3612,68302523,2683000,2683050,1252300,1252350,3,3,0,0,0,0,6,3,0,0,0,0,3,6,12
3613,68302526,2683000,2683050,1252600,1252650,3,4,4,0,0,0,11,4,3,3,0,3,0,13,24
3614,68302539,2683000,2683050,1253900,1253950,0,0,0,3,0,0,3,3,0,0,0,0,0,3,6
3615,68302529,2683000,2683050,1252900,1252950,3,3,0,0,0,0,6,3,3,3,3,0,0,12,18
3616,68312531,2683100,2683150,1253100,1253150,0,3,3,0,3,0,9,0,3,3,3,3,3,15,24
3617,68312538,2683100,2683150,1253800,1253850,0,3,3,0,3,0,9,3,0,3,0,3,3,12,21
3618,68312524,2683100,2683150,1252400,1252450,0,0,0,0,0,0,0,0,3,0,0,0,0,3,3
3619,68322432,2683200,2683250,1243200,1243250,0,3,3,3,3,3,15,3,3,0,3,0,3,12,27
3620,68322515,2683200,2683250,1251500,1251550,8,0,0,0,0,0,8,3,0,0,3,3,3,12,20
3621,68322496,2683200,2683250,1249600,1249650,3,3,3,3,3,0,15,0,3,0,0,3,0,6,21
3622,68322492,2683200,2683250,1249200,1249250,3,0,0,0,0,0,3,0,0,0,0,0,0,0,3
3623,68322511,2683200,2683250,1251100,1251150,0,0,0,0,0,0,0,0,0,0,0,0,0,0,0
3624,68332529,2683300,2683350,1252900,1252950,0,0,0,3,0,0,3,3,0,3,0,0,0,6,9
3625,68332490,2683300,2683350,1249000,1249050,3,4,3,3,0,0,13,5,3,3,0,3,0,14,27
3626,68332468,2683300,2683350,1246800,1246850,0,0,0,0,0,0,0,0,0,0,0,0,0,0,0
3627,68332507,2683300,2683350,1250700,1250750,5,3,3,3,0,0,14,4,3,3,3,3,3,19,33
3628,68332530,2683300,2683350,1253000,1253050,3,3,0,0,0,3,9,3,0,3,3,3,0,12,21
3629,68332483,2683300,2683350,1248300,1248350,3,0,0,0,0,0,3,3,3,3,0,0,0,9,12
3630,68342529,2683400,2683450,1252900,1252950,3,3,0,3,0,0,9,3,0,0,3,3,3,12,21
3631,68342533,2683400,2683450,1253300,1253350,3,5,4,3,0,3,18,3,3,4,3,0,0,13,31
3632,68342489,2683400,2683450,1248900,1248950,3,3,3,0,0,3,12,3,5,3,3,0,3,17,29
3633,68342474,2683400,2683450,1247400,1247450,7,10,4,3,0,0,24,3,5,5,3,3,0,19,43
3634,68342530,2683400,2683450,1253000,1253050,3,6,4,3,0,0,16,5,3,3,3,3,0,17,33
3635,68342473,2683400,2683450,1247300,1247350,4,0,0,0,0,0,4,3,3,0,0,0,0,6,10
3636,68342492,2683400,2683450,1249200,1249250,3,3,0,0,0,0,6,3,3,3,0,0,0,9,15
3637,68342528,2683400,2683450,1252800,1252850,0,0,0,0,0,0,0,0,0,0,0,0,0,0,0
3638,68352531,2683500,2683550,1253100,1253150,0,3,0,0,0,0,3,3,0,3,0,0,0,6,9
3639,68352485,2683500,2683550,1248500,1248550,4,3,3,0,0,0,10,3,3,3,3,0,0,12,22
3640,68362521,2683600,2683650,1252100,1252150,4,0,3,0,3,0,10,3,3,3,0,0,3,12,22
3641,68362511,2683600,2683650,1251100,1251150,3,0,0,0,0,0,3,3,3,3,0,3,3,15,18
3642,68362468,2683600,2683650,1246800,1246850,0,0,0,0,0,0,0,0,0,0,3,0,0,3,3
3643,68362520,2683600,2683650,1252000,1252050,0,0,0,0,0,0,0,0,0,0,0,0,0,0,0
3644,68372506,2683700,2683750,1250600,1250650,0,0,3,3,0,3,9,3,3,3,3,3,0,15,24
3645,68372525,2683700,2683750,1252500,1252550,3,3,3,3,3,0,15,3,4,3,3,3,3,19,34
3646,68372511,2683700,2683750,1251100,1251150,3,3,3,3,0,3,15,3,3,3,3,3,0,15,30
3647,68372535,2683700,2683750,1253500,1253550,6,0,4,4,3,3,20,3,6,3,3,3,3,21,41
3648,68382485,2683800,2683850,1248500,1248550,3,0,3,3,0,0,9,3,3,3,3,0,0,12,21
3649,68382490,2683800,2683850,1249000,1249050,3,4,3,3,3,0,16,3,3,5,0,3,0,14,30
3650,68382489,2683800,2683850,1248900,1248950,3,0,4,3,3,3,16,3,4,3,4,0,0,14,30
3651,68382508,2683800,2683850,1250800,1250850,0,3,3,0,0,0,6,3,4,3,0,0,0,10,16
3652,68382522,2683800,2683850,1252200,1252250,3,0,0,0,0,0,3,3,0,0,3,0,0,6,9
3653,68382528,2683800,2683850,1252800,1252850,3,3,3,0,0,0,9,3,7,3,0,0,0,13,22
3654,68382464,2683800,2683850,1246400,1246450,3,3,3,3,3,0,15,5,3,3,0,0,3,14,29
3655,68382470,2683800,2683850,1247000,1247050,3,0,0,0,0,0,3,0,3,0,0,0,0,3,6
3656,68392464,2683900,2683950,1246400,1246450,3,3,3,3,3,0,15,4,6,4,3,3,3,23,38
3657,68402510,2684000,2684050,1251000,1251050,3,3,0,3,3,0,12,4,0,3,3,4,0,14,26
3658,68402509,2684000,2684050,1250900,1250950,3,3,3,3,3,0,15,4,3,4,3,3,3,20,35
3659,68402484,2684000,2684050,1248400,1248450,3,3,0,0,3,0,9,3,3,3,3,0,3,15,24
3660,68402525,2684000,2684050,1252500,1252550,3,3,3,0,0,0,9,3,3,0,3,0,0,9,18
3661,68402497,2684000,2684050,1249700,1249750,3,0,3,0,0,0,6,0,3,3,0,0,0,6,12
3662,68402468,2684000,2684050,1246800,1246850,3,0,0,0,0,0,3,0,0,3,0,0,0,3,6
3663,68412469,2684100,2684150,1246900,1246950,3,0,3,3,0,0,9,0,0,0,3,0,0,3,12
3664,68412492,2684100,2684150,1249200,1249250,0,0,0,0,0,0,0,0,0,0,0,0,0,0,0
3665,68412472,2684100,2684150,1247200,1247250,3,0,0,0,3,0,6,3,0,3,3,3,3,15,21
3666,68412533,2684100,2684150,1253300,1253350,0,0,3,0,0,0,3,0,3,3,0,3,0,9,12
3667,68412536,2684100,2684150,1253600,1253650,3,5,0,0,4,0,12,0,3,3,5,3,0,14,26
3668,68412475,2684100,2684150,1247500,1247550,3,3,0,0,0,0,6,3,3,0,0,0,0,6,12
3669,68412511,2684100,2684150,1251100,1251150,3,3,4,3,0,0,13,4,3,0,3,3,3,16,29
3670,68412471,2684100,2684150,1247100,1247150,3,3,3,3,3,3,18,3,5,5,4,0,6,23,41
3671,68412535,2684100,2684150,1253500,1253550,11,5,6,3,4,0,29,10,7,8,3,3,0,31,60
3672,68412476,2684100,2684150,1247600,1247650,3,0,0,0,0,0,3,0,0,0,0,0,0,0,3
3673,68422464,2684200,2684250,1246400,1246450,0,3,3,3,0,0,9,3,3,4,4,3,0,17,26
3674,68422477,2684200,2684250,1247700,1247750,0,3,3,3,3,0,12,3,3,3,3,0,3,15,27
3675,68432480,2684300,2684350,1248000,1248050,3,3,3,3,3,0,15,3,4,5,3,3,0,18,33
3676,68432515,2684300,2684350,1251500,1251550,3,3,0,3,0,0,9,4,0,3,0,0,0,7,16
3677,68432512,2684300,2684350,1251200,1251250,0,0,0,3,0,0,3,3,0,0,3,0,3,9,12
3678,68442488,2684400,2684450,1248800,1248850,3,3,0,3,0,0,9,0,3,0,0,3,0,6,15
3679,68442458,2684400,2684450,1245800,1245850,3,3,3,3,0,0,12,4,3,3,3,3,3,19,31
3680,68442467,2684400,2684450,1246700,1246750,0,3,3,0,0,0,6,3,3,3,0,3,0,12,18
3681,68442469,2684400,2684450,1246900,1246950,5,5,3,0,3,3,19,7,8,4,3,3,3,28,47
3682,68452477,2684500,2684550,1247700,1247750,3,3,4,3,0,3,16,5,3,3,3,3,3,20,36
3683,68452478,2684500,2684550,1247800,1247850,3,3,3,0,0,0,9,4,0,3,0,0,0,7,16
3684,68452455,2684500,2684550,1245500,1245550,6,4,4,3,3,3,23,4,7,6,3,3,3,26,49
3685,68462456,2684600,2684650,1245600,1245650,3,3,0,0,0,0,6,0,0,0,3,0,0,3,9
3686,68462511,2684600,2684650,1251100,1251150,0,3,0,0,0,3,6,7,3,3,0,0,0,13,19
3687,68462514,2684600,2684650,1251400,1251450,0,4,3,3,0,0,10,3,3,3,3,0,0,12,22
3688,68462464,2684600,2684650,1246400,1246450,3,3,3,3,0,0,12,3,4,0,0,0,0,7,19
3689,68462476,2684600,2684650,1247600,1247650,3,3,0,3,0,0,9,0,3,3,0,0,0,6,15
3690,68462484,2684600,2684650,1248400,1248450,0,3,3,3,0,0,9,3,3,3,3,3,0,15,24
3691,68462457,2684600,2684650,1245700,1245750,0,0,3,0,0,0,3,0,0,3,3,0,0,6,9
3692,68472514,2684700,2684750,1251400,1251450,3,3,3,0,0,3,12,3,3,4,3,3,0,16,28
3693,68472515,2684700,2684750,1251500,1251550,3,0,3,3,3,0,12,3,3,4,3,3,0,16,28
3694,68472457,2684700,2684750,1245700,1245750,0,0,3,0,0,0,3,0,3,0,0,0,0,3,6
3695,68482464,2684800,2684850,1246400,1246450,0,4,3,0,3,0,10,5,3,3,0,3,3,17,27
3696,68482484,2684800,2684850,1248400,1248450,3,0,3,0,0,0,6,3,3,3,0,0,0,9,15
3697,68482478,2684800,2684850,1247800,1247850,3,0,0,3,0,0,6,3,4,3,3,3,3,19,25
3698,68492518,2684900,2684950,1251800,1251850,3,3,3,0,0,0,9,3,3,0,0,0,0,6,15
3699,68492468,2684900,2684950,1246800,1246850,3,3,4,3,0,0,13,4,3,5,3,3,0,18,31
3700,68492448,2684900,2684950,1244800,1244850,3,0,3,3,0,0,9,0,3,3,0,0,0,6,15
3701,68502515,2685000,2685050,1251500,1251550,3,3,3,0,0,3,12,3,3,3,0,0,3,12,24
3702,68502470,2685000,2685050,1247000,1247050,3,0,3,0,0,0,6,3,3,3,3,0,0,12,18
3703,68502456,2685000,2685050,1245600,1245650,0,0,0,0,0,0,0,0,0,0,0,0,0,0,0
3704,68522521,2685200,2685250,1252100,1252150,3,3,3,0,0,0,9,3,3,3,0,3,0,12,21
3705,68522451,2685200,2685250,1245100,1245150,3,3,3,3,0,0,12,3,3,3,0,0,0,9,21
3706,68532482,2685300,2685350,1248200,1248250,0,3,0,3,0,0,6,0,3,0,3,0,0,6,12
3707,68532517,2685300,2685350,1251700,1251750,3,0,0,0,0,0,3,3,3,0,3,0,0,9,12
3708,68532518,2685300,2685350,1251800,1251850,0,0,0,0,0,0,0,0,0,0,0,0,0,0,0
3709,68542522,2685400,2685450,1252200,1252250,0,0,0,0,0,0,0,3,0,0,0,0,0,3,3
3710,68542471,2685400,2685450,1247100,1247150,0,0,0,0,0,0,0,0,0,0,0,0,0,0,0
3711,68542514,2685400,2685450,1251400,1251450,3,3,0,3,3,0,12,3,3,0,3,3,3,15,27
3712,68552457,2685500,2685550,1245700,1245750,0,0,0,0,0,0,0,0,0,0,0,0,0,0,0
3713,68562463,2685600,2685650,1246300,1246350,3,3,0,0,0,0,6,3,0,0,0,0,0,3,9
3714,68562513,2685600,2685650,1251300,1251350,0,0,3,0,3,9,15,0,0,0,5,16,44,65,80
3715,68572453,2685700,2685750,1245300,1245350,0,0,0,0,0,0,0,0,0,0,0,0,0,0,0
3716,68592458,2685900,2685950,1245800,1245850,0,0,3,0,0,0,3,0,0,3,0,0,0,3,6
3717,68602453,2686000,2686050,1245300,1245350,0,0,3,0,0,0,3,3,3,3,3,3,3,18,21
3718,68612457,2686100,2686150,1245700,1245750,0,0,3,4,3,0,10,3,3,3,3,0,0,12,22
3719,68612461,2686100,2686150,1246100,1246150,0,3,0,3,0,0,6,3,3,0,0,3,0,9,15
3720,68622507,2686200,2686250,1250700,1250750,3,3,3,0,0,0,9,4,4,3,3,3,0,17,26
3721,68622460,2686200,2686250,1246000,1246050,3,3,0,3,0,0,9,3,0,4,3,3,3,16,25
3722,68632513,2686300,2686350,1251300,1251350,3,4,3,3,0,3,16,5,6,3,3,0,0,17,33
3723,68642462,2686400,2686450,1246200,1246250,3,0,3,3,0,0,9,0,4,3,3,0,0,10,19
3724,68652455,2686500,2686550,1245500,1245550,0,0,0,0,0,0,0,0,0,3,3,0,0,6,6
3725,68652513,2686500,2686550,1251300,1251350,0,0,0,3,0,0,3,3,0,0,0,3,3,9,12
3726,68662506,2686600,2686650,1250600,1250650,3,3,3,0,3,0,12,3,0,0,0,0,0,3,15
3727,68662508,2686600,2686650,1250800,1250850,3,3,4,0,3,3,16,4,3,4,3,3,3,20,36
3728,68662512,2686600,2686650,1251200,1251250,3,3,4,0,0,0,10,5,3,3,0,0,0,11,21
3729,68672510,2686700,2686750,1251000,1251050,3,3,3,3,0,0,12,3,3,3,3,0,0,12,24
3730,68672509,2686700,2686750,1250900,1250950,3,3,3,0,3,0,12,3,3,3,4,3,3,19,31
3731,68682485,2686800,2686850,1248500,1248550,0,0,0,0,0,0,0,0,0,0,0,0,0,0,0
3732,68682457,2686800,2686850,1245700,1245750,3,3,3,0,0,0,9,0,3,0,3,3,3,12,21
3733,68692456,2686900,2686950,1245600,1245650,4,4,3,0,3,0,14,3,5,4,3,0,3,18,32
3734,68702507,2687000,2687050,1250700,1250750,3,3,3,0,0,0,9,3,0,3,0,3,0,9,18
3735,68702486,2687000,2687050,1248600,1248650,0,0,3,0,0,0,3,0,0,3,0,0,0,3,6
3736,68712457,2687100,2687150,1245700,1245750,3,3,3,0,0,3,12,3,3,3,3,0,3,15,27
3737,68712511,2687100,2687150,1251100,1251150,0,3,0,3,0,0,6,0,0,3,0,0,0,3,9
3738,68712466,2687100,2687150,1246600,1246650,0,0,0,0,0,0,0,3,0,0,3,0,3,9,9
3739,68712465,2687100,2687150,1246500,1246550,0,0,0,0,0,3,3,0,0,0,0,3,0,3,6
3740,68722505,2687200,2687250,1250500,1250550,4,5,5,6,4,10,34,4,4,6,17,33,36,100,134
3741,68732459,2687300,2687350,1245900,1245950,0,3,3,0,0,0,6,3,3,3,3,3,0,15,21
3742,68742466,2687400,2687450,1246600,1246650,3,3,3,0,0,0,9,0,3,3,3,3,0,12,21
3743,68762460,2687600,2687650,1246000,1246050,0,3,4,0,0,0,7,4,5,3,3,3,0,18,25
3744,68782455,2687800,2687850,1245500,1245550,5,3,4,5,4,5,26,3,3,12,10,26,39,93,119
3745,68792461,2687900,2687950,1246100,1246150,0,0,0,0,0,0,0,0,0,3,3,0,0,6,6
3746,68792465,2687900,2687950,1246500,1246550,0,0,0,0,0,0,0,0,0,0,0,0,0,0,0
3747,68102432,2681000,2681050,1243200,1243250,0,0,3,0,0,0,3,0,0,3,0,0,0,3,6
3748,67822497,2678200,2678250,1249700,1249750,0,0,3,0,0,0,3,0,0,0,0,0,0,0,3
3749,67972446,2679700,2679750,1244600,1244650,0,0,0,0,0,0,0,0,0,0,0,0,0,0,0
3750,68322522,2683200,2683250,1252200,1252250,3,3,0,0,0,0,6,3,0,0,0,0,0,3,9
3751,68412490,2684100,2684150,1249000,1249050,3,0,0,0,0,0,3,0,0,3,0,3,0,6,9
3752,68412504,2684100,2684150,1250400,1250450,0,0,0,0,0,0,0,0,0,0,0,0,0,0,0
3753,68382529,2683800,2683850,1252900,1252950,3,3,0,3,3,0,12,3,3,4,7,3,6,26,38
3754,67772492,2677700,2677750,1249200,1249250,3,0,3,3,0,3,12,3,3,3,3,3,0,15,27
3755,67782495,2677800,2677850,1249500,1249550,0,3,7,5,3,3,21,3,3,8,3,3,0,20,41
3756,67792494,2677900,2677950,1249400,1249450,3,3,3,0,0,3,12,3,3,0,0,3,3,12,24
3757,67812520,2678100,2678150,1252000,1252050,0,0,0,0,3,0,3,0,0,0,0,0,0,0,3
3758,67842521,2678400,2678450,1252100,1252150,3,5,6,3,3,0,20,6,9,3,3,3,0,24,44
3759,67842520,2678400,2678450,1252000,1252050,4,8,4,0,3,0,19,3,6,6,4,0,0,19,38
3760,67852521,2678500,2678550,1252100,1252150,3,5,3,3,0,0,14,7,4,4,3,3,0,21,35
3761,67852483,2678500,2678550,1248300,1248350,0,3,3,0,3,0,9,0,3,3,3,3,0,12,21
3762,67862518,2678600,2678650,1251800,1251850,5,5,3,3,3,0,19,7,8,6,3,3,3,30,49
3763,67872489,2678700,2678750,1248900,1248950,3,3,3,3,3,3,18,3,3,3,4,3,0,16,34
3764,67872491,2678700,2678750,1249100,1249150,0,3,3,0,0,0,6,4,3,3,3,0,0,13,19
3765,67872473,2678700,2678750,1247300,1247350,0,0,0,0,0,0,0,0,0,0,0,0,0,0,0
3766,67882475,2678800,2678850,1247500,1247550,0,3,3,0,0,0,6,3,3,0,0,0,3,9,15
3767,67892476,2678900,2678950,1247600,1247650,3,3,3,0,0,0,9,3,3,0,0,0,0,6,15
3768,67902490,2679000,2679050,1249000,1249050,0,0,0,0,0,0,0,0,0,0,0,0,0,0,0
3769,67902483,2679000,2679050,1248300,1248350,3,3,4,3,3,3,19,4,3,0,3,3,3,16,35
3770,67912516,2679100,2679150,1251600,1251650,4,3,3,0,3,0,13,4,3,3,0,0,0,10,23
3771,67912475,2679100,2679150,1247500,1247550,4,3,4,5,0,0,16,3,11,6,3,3,3,29,45
3772,67912494,2679100,2679150,1249400,1249450,0,3,3,3,0,0,9,3,3,0,0,0,0,6,15
3773,67932489,2679300,2679350,1248900,1248950,4,3,4,3,3,0,17,7,5,3,3,0,0,18,35
3774,67932490,2679300,2679350,1249000,1249050,5,4,0,3,3,0,15,3,3,3,5,3,3,20,35
3775,67942475,2679400,2679450,1247500,1247550,3,0,5,3,0,0,11,3,3,4,3,0,3,16,27
3776,67942513,2679400,2679450,1251300,1251350,3,3,0,0,0,0,6,3,0,3,0,0,0,6,12
3777,67942505,2679400,2679450,1250500,1250550,0,3,3,3,3,0,12,3,5,4,3,3,0,18,30
3778,67942491,2679400,2679450,1249100,1249150,4,3,3,3,3,3,19,6,0,0,5,3,3,17,36
3779,67942474,2679400,2679450,1247400,1247450,3,3,3,3,0,0,12,4,0,3,3,0,3,13,25
3780,67952511,2679500,2679550,1251100,1251150,3,0,3,0,3,3,12,5,3,7,5,3,3,26,38
3781,67952501,2679500,2679550,1250100,1250150,3,0,3,0,3,0,9,3,3,3,0,0,0,9,18
3782,67952486,2679500,2679550,1248600,1248650,0,0,0,0,0,0,0,0,0,3,0,0,0,3,3
3783,67962465,2679600,2679650,1246500,1246550,3,0,3,0,3,0,9,4,0,3,0,0,0,7,16
3784,67962479,2679600,2679650,1247900,1247950,3,3,3,3,0,0,12,3,3,3,0,3,0,12,24
3785,67972512,2679700,2679750,1251200,1251250,3,3,3,3,0,0,12,3,3,0,0,0,0,6,18
3786,67982489,2679800,2679850,1248900,1248950,3,0,3,3,0,0,9,3,3,3,0,0,0,9,18
3787,67992507,2679900,2679950,1250700,1250750,5,3,3,0,0,3,14,4,4,3,3,3,3,20,34
3788,67992485,2679900,2679950,1248500,1248550,9,4,3,3,0,0,19,6,3,4,0,0,0,13,32
3789,67992508,2679900,2679950,1250800,1250850,0,3,0,3,7,13,26,3,0,3,6,17,18,47,73
3790,67992504,2679900,2679950,1250400,1250450,0,0,0,0,0,0,0,0,0,0,0,0,0,0,0
3791,67992475,2679900,2679950,1247500,1247550,4,3,3,3,3,0,16,3,3,3,3,3,0,15,31
3792,68002483,2680000,2680050,1248300,1248350,0,3,3,0,0,0,6,4,3,3,3,0,0,13,19
3793,68002533,2680000,2680050,1253300,1253350,0,0,3,0,0,0,3,0,3,3,3,0,0,9,12
3794,68012525,2680100,2680150,1252500,1252550,3,3,0,0,0,0,6,3,3,0,0,0,0,6,12
3795,68022525,2680200,2680250,1252500,1252550,3,3,3,3,0,3,15,3,3,3,3,3,3,18,33
3796,68022483,2680200,2680250,1248300,1248350,3,3,0,3,3,0,12,3,4,3,0,3,0,13,25
3797,68022523,2680200,2680250,1252300,1252350,3,3,0,0,0,0,6,3,3,0,0,3,0,9,15
3798,68022501,2680200,2680250,1250100,1250150,3,6,3,0,3,0,15,3,3,3,3,0,3,15,30
3799,68022463,2680200,2680250,1246300,1246350,0,3,0,0,0,3,6,3,3,0,0,0,0,6,12
3800,68032505,2680300,2680350,1250500,1250550,3,0,0,3,0,0,6,0,0,0,3,0,3,6,12
3801,68042507,2680400,2680450,1250700,1250750,3,0,3,0,0,0,6,0,3,3,0,3,0,9,15
3802,68042469,2680400,2680450,1246900,1246950,0,3,0,0,0,0,3,3,0,0,0,0,0,3,6
3803,68042525,2680400,2680450,1252500,1252550,0,0,0,0,0,0,0,0,0,0,0,0,0,0,0
3804,68042459,2680400,2680450,1245900,1245950,3,0,0,0,0,0,3,0,0,0,0,0,0,0,3
3805,68042522,2680400,2680450,1252200,1252250,3,3,3,0,0,0,9,3,3,0,0,0,0,6,15
3806,68052469,2680500,2680550,1246900,1246950,3,3,0,0,0,0,6,3,3,0,3,3,0,12,18
3807,68052504,2680500,2680550,1250400,1250450,3,3,0,3,3,0,12,3,3,0,3,0,0,9,21
3808,68052461,2680500,2680550,1246100,1246150,3,3,3,0,0,3,12,3,3,3,3,3,9,24,36
3809,68062486,2680600,2680650,1248600,1248650,0,0,0,3,0,0,3,0,0,0,0,3,0,3,6
3810,68062506,2680600,2680650,1250600,1250650,3,3,4,3,0,0,13,3,3,3,0,0,0,9,22
3811,68062464,2680600,2680650,1246400,1246450,3,0,0,0,0,0,3,3,0,0,0,0,0,3,6
3812,68062485,2680600,2680650,1248500,1248550,0,0,0,0,0,0,0,0,0,0,0,0,0,0,0
3813,68062502,2680600,2680650,1250200,1250250,3,3,0,0,0,0,6,3,0,3,5,0,3,14,20
3814,68062458,2680600,2680650,1245800,1245850,3,0,0,0,0,0,3,3,0,0,0,0,0,3,6
3815,68072506,2680700,2680750,1250600,1250650,0,0,3,3,0,0,6,3,3,3,3,3,0,15,21
3816,68072420,2680700,2680750,1242000,1242050,0,0,3,0,0,0,3,0,3,0,0,0,0,3,6
3817,68082459,2680800,2680850,1245900,1245950,3,3,3,0,0,0,9,9,4,3,3,3,3,25,34
3818,68082467,2680800,2680850,1246700,1246750,3,3,3,0,0,3,12,3,3,3,0,3,3,15,27
3819,68082518,2680800,2680850,1251800,1251850,3,0,3,3,0,0,9,3,3,0,3,0,0,9,18
3820,68082483,2680800,2680850,1248300,1248350,22,32,10,8,4,3,79,20,27,17,11,9,5,89,168
3821,68092468,2680900,2680950,1246800,1246850,3,0,0,0,0,0,3,3,3,3,3,3,0,15,18
3822,68092426,2680900,2680950,1242600,1242650,0,0,0,0,0,0,0,0,0,0,0,0,0,0,0
3823,68102467,2681000,2681050,1246700,1246750,4,3,0,0,0,0,7,6,4,3,3,3,3,22,29
3824,68102484,2681000,2681050,1248400,1248450,3,0,0,0,0,0,3,3,3,0,0,0,3,9,12
3825,68102479,2681000,2681050,1247900,1247950,3,3,0,0,0,0,6,0,0,0,0,0,0,0,6
3826,68112479,2681100,2681150,1247900,1247950,3,4,3,0,0,0,10,3,3,0,3,0,0,9,19
3827,68112468,2681100,2681150,1246800,1246850,3,3,3,3,0,3,15,3,3,4,5,3,0,18,33
3828,68112491,2681100,2681150,1249100,1249150,0,0,0,0,0,0,0,0,0,0,0,0,0,0,0
3829,68122502,2681200,2681250,1250200,1250250,3,0,0,3,3,3,12,3,0,3,0,3,3,12,24
3830,68122520,2681200,2681250,1252000,1252050,3,0,4,3,3,0,13,3,3,3,3,3,0,15,28
3831,68122469,2681200,2681250,1246900,1246950,4,3,3,3,3,0,16,7,4,4,0,0,3,18,34
3832,68122482,2681200,2681250,1248200,1248250,3,3,0,0,0,3,9,3,3,0,0,0,3,9,18
3833,68122503,2681200,2681250,1250300,1250350,0,0,0,0,3,0,3,0,0,0,3,0,0,3,6
3834,68122458,2681200,2681250,1245800,1245850,3,3,3,4,4,3,20,3,3,7,3,4,0,20,40
3835,68132427,2681300,2681350,1242700,1242750,0,0,0,3,0,0,3,0,3,3,0,0,0,6,9
3836,68132477,2681300,2681350,1247700,1247750,4,3,3,5,0,0,15,6,3,4,0,0,0,13,28
3837,68132483,2681300,2681350,1248300,1248350,7,3,0,0,3,0,13,4,3,0,0,0,0,7,20
3838,68142499,2681400,2681450,1249900,1249950,3,3,3,3,3,7,22,3,7,3,8,18,36,75,97
3839,68142496,2681400,2681450,1249600,1249650,0,0,3,3,0,0,6,0,0,4,0,0,0,4,10
3840,68142478,2681400,2681450,1247800,1247850,3,3,3,3,3,0,15,5,6,5,3,0,0,19,34
3841,68152480,2681500,2681550,1248000,1248050,0,0,0,0,0,0,0,0,0,0,0,0,0,0,0
3842,68152497,2681500,2681550,1249700,1249750,4,3,0,3,3,0,13,3,3,0,0,3,0,9,22
3843,68162477,2681600,2681650,1247700,1247750,0,3,3,0,0,0,6,0,3,0,3,0,3,9,15
3844,68162478,2681600,2681650,1247800,1247850,3,3,3,4,3,3,19,0,3,3,4,3,3,16,35
3845,68162463,2681600,2681650,1246300,1246350,3,3,0,0,0,0,6,3,0,3,0,0,0,6,12
3846,68162480,2681600,2681650,1248000,1248050,3,3,3,0,0,0,9,3,3,0,3,0,0,9,18
3847,68172498,2681700,2681750,1249800,1249850,3,0,3,0,0,0,6,3,0,3,0,0,0,6,12
3848,68172478,2681700,2681750,1247800,1247850,3,3,3,0,0,0,9,3,0,3,0,0,0,6,15
3849,68172433,2681700,2681750,1243300,1243350,0,0,0,0,0,0,0,3,0,0,0,0,0,3,3
3850,68172516,2681700,2681750,1251600,1251650,0,0,3,0,0,0,3,0,0,3,3,0,0,6,9
3851,68172495,2681700,2681750,1249500,1249550,0,0,0,0,0,0,0,3,0,0,3,0,0,6,6
3852,68172477,2681700,2681750,1247700,1247750,0,0,0,0,0,0,0,0,0,0,0,0,0,0,0
3853,68182481,2681800,2681850,1248100,1248150,3,3,0,3,3,3,15,3,0,3,3,0,0,9,24
3854,68182471,2681800,2681850,1247100,1247150,3,3,3,3,0,0,12,3,5,0,3,3,3,17,29
3855,68182477,2681800,2681850,1247700,1247750,0,3,0,3,0,0,6,0,3,3,0,3,0,9,15
3856,68182503,2681800,2681850,1250300,1250350,3,0,0,0,0,0,3,0,3,3,0,0,0,6,9
3857,68182494,2681800,2681850,1249400,1249450,0,3,0,0,0,0,3,0,0,0,0,0,0,0,3
3858,68202522,2682000,2682050,1252200,1252250,3,3,0,3,0,0,9,4,0,0,3,3,3,13,22
3859,68202519,2682000,2682050,1251900,1251950,3,0,3,4,4,0,14,4,3,3,3,3,3,19,33
3860,68202523,2682000,2682050,1252300,1252350,3,0,3,0,0,0,6,0,0,3,0,0,0,3,9
3861,68202477,2682000,2682050,1247700,1247750,3,0,3,3,3,0,12,3,3,3,0,0,0,9,21
3862,68202448,2682000,2682050,1244800,1244850,0,0,0,3,0,0,3,3,0,0,0,0,0,3,6
3863,68202461,2682000,2682050,1246100,1246150,3,0,0,0,0,3,6,3,0,0,0,0,0,3,9
3864,68212491,2682100,2682150,1249100,1249150,3,0,0,0,0,0,3,3,0,0,0,0,0,3,6
3865,68212518,2682100,2682150,1251800,1251850,0,3,3,3,3,0,12,3,3,3,3,3,0,15,27
3866,68212471,2682100,2682150,1247100,1247150,0,0,3,0,0,0,3,0,0,3,3,0,3,9,12
3867,68212434,2682100,2682150,1243400,1243450,9,4,0,3,3,0,19,9,9,4,3,0,0,25,44
3868,68212467,2682100,2682150,1246700,1246750,0,0,3,3,9,11,26,0,3,4,9,22,18,56,82
3869,68212462,2682100,2682150,1246200,1246250,3,0,0,0,0,0,3,3,0,3,0,0,0,6,9
3870,68212468,2682100,2682150,1246800,1246850,3,3,3,0,0,0,9,0,3,3,0,0,0,6,15
3871,68222501,2682200,2682250,1250100,1250150,0,3,3,3,3,0,12,3,3,3,0,0,0,9,21
3872,68222540,2682200,2682250,1254000,1254050,0,0,0,0,0,0,0,0,0,0,0,0,0,0,0
3873,68232449,2682300,2682350,1244900,1244950,4,3,3,3,0,0,13,9,3,4,3,3,3,25,38
3874,68232493,2682300,2682350,1249300,1249350,3,3,0,3,3,0,12,3,3,3,0,3,0,12,24
3875,68232539,2682300,2682350,1253900,1253950,0,0,0,0,3,0,3,0,0,0,3,0,0,3,6
3876,68242485,2682400,2682450,1248500,1248550,4,3,3,3,0,0,13,0,3,3,0,0,0,6,19
3877,68242498,2682400,2682450,1249800,1249850,6,3,3,3,3,0,18,3,3,3,3,0,0,12,30
3878,68242454,2682400,2682450,1245400,1245450,0,3,3,3,3,0,12,3,3,4,3,3,0,16,28
3879,68252445,2682500,2682550,1244500,1244550,0,3,0,0,0,0,3,0,0,3,3,0,3,9,12
3880,68252519,2682500,2682550,1251900,1251950,0,3,0,0,0,0,3,0,0,3,0,0,0,3,6
3881,68262501,2682600,2682650,1250100,1250150,3,3,0,0,3,0,9,6,3,3,3,3,0,18,27
3882,68272434,2682700,2682750,1243400,1243450,3,3,0,3,0,0,9,4,3,0,0,0,0,7,16
3883,68282463,2682800,2682850,1246300,1246350,0,0,0,0,0,0,0,0,0,0,0,0,0,0,0
3884,68282493,2682800,2682850,1249300,1249350,3,0,0,0,3,3,9,3,0,3,3,3,0,12,21
3885,68292441,2682900,2682950,1244100,1244150,3,0,0,0,0,0,3,3,3,0,0,0,0,6,9
3886,68292498,2682900,2682950,1249800,1249850,7,3,4,3,0,0,17,3,6,3,3,3,0,18,35
3887,68292513,2682900,2682950,1251300,1251350,3,0,0,0,0,0,3,3,0,0,0,3,0,6,9
3888,68292503,2682900,2682950,1250300,1250350,3,0,0,3,0,0,6,3,3,0,3,3,0,12,18
3889,68292438,2682900,2682950,1243800,1243850,3,0,0,0,0,0,3,3,0,0,0,0,0,3,6
3890,68292528,2682900,2682950,1252800,1252850,3,3,0,0,0,0,6,0,3,3,3,0,0,9,15
3891,68302437,2683000,2683050,1243700,1243750,0,0,0,0,0,0,0,0,0,0,0,0,0,0,0
3892,68302479,2683000,2683050,1247900,1247950,3,0,0,0,0,0,3,3,0,0,0,0,0,3,6
3893,68302521,2683000,2683050,1252100,1252150,0,0,3,0,0,0,3,0,0,0,0,0,0,0,3
3894,68302528,2683000,2683050,1252800,1252850,3,3,0,0,3,0,9,4,3,0,3,3,0,13,22
3895,68302488,2683000,2683050,1248800,1248850,3,3,3,0,0,0,9,3,3,0,3,3,3,15,24
3896,68302486,2683000,2683050,1248600,1248650,0,0,3,0,0,0,3,0,0,0,0,0,0,0,3
3897,68312433,2683100,2683150,1243300,1243350,0,0,0,0,0,0,0,0,0,3,0,0,0,3,3
3898,68312521,2683100,2683150,1252100,1252150,3,0,0,0,0,0,3,3,3,0,0,0,0,6,9
3899,68312530,2683100,2683150,1253000,1253050,3,3,3,3,0,0,12,3,3,3,3,3,0,15,27
3900,68312488,2683100,2683150,1248800,1248850,3,3,3,0,0,0,9,0,3,0,0,0,0,3,12
3901,68312525,2683100,2683150,1252500,1252550,0,0,0,0,0,0,0,0,0,0,0,0,0,0,0
3902,68322472,2683200,2683250,1247200,1247250,3,3,3,3,0,0,12,3,3,3,3,0,0,12,24
3903,68322498,2683200,2683250,1249800,1249850,3,3,3,0,3,3,15,10,3,5,5,4,0,27,42
3904,68322493,2683200,2683250,1249300,1249350,7,3,0,0,0,0,10,3,0,3,0,3,0,9,19
3905,68322509,2683200,2683250,1250900,1250950,3,3,0,3,0,0,9,0,3,0,3,0,0,6,15
3906,68322474,2683200,2683250,1247400,1247450,3,3,3,0,3,0,12,3,3,3,0,3,3,15,27
3907,68332474,2683300,2683350,1247400,1247450,3,3,3,3,0,0,12,3,3,7,3,0,0,16,28
3908,68332533,2683300,2683350,1253300,1253350,3,3,3,0,0,0,9,3,3,4,4,3,3,20,29
3909,68332493,2683300,2683350,1249300,1249350,4,3,3,3,3,0,16,4,3,3,3,3,3,19,35
3910,68332532,2683300,2683350,1253200,1253250,0,3,0,0,0,0,3,0,0,0,0,0,0,0,3
3911,68342513,2683400,2683450,1251300,1251350,5,3,3,0,3,3,17,6,3,6,3,7,3,28,45
3912,68342485,2683400,2683450,1248500,1248550,0,0,3,3,0,3,9,5,3,0,0,3,3,14,23
3913,68352491,2683500,2683550,1249100,1249150,3,3,3,3,3,0,15,3,5,0,3,0,0,11,26
3914,68362499,2683600,2683650,1249900,1249950,0,3,3,0,0,0,6,0,3,3,0,3,0,9,15
3915,68362472,2683600,2683650,1247200,1247250,3,7,3,0,3,0,16,3,3,3,3,3,3,18,34
3916,68362474,2683600,2683650,1247400,1247450,5,4,3,3,3,0,18,6,7,8,3,6,3,33,51
3917,68362533,2683600,2683650,1253300,1253350,3,3,3,0,3,3,15,3,4,5,3,3,0,18,33
3918,68372505,2683700,2683750,1250500,1250550,0,0,0,0,0,0,0,0,0,0,0,0,0,0,0
3919,68372493,2683700,2683750,1249300,1249350,3,3,3,0,0,0,9,3,3,0,4,0,0,10,19
3920,68372518,2683700,2683750,1251800,1251850,3,5,3,3,0,0,14,4,4,3,3,3,3,20,34
3921,68372496,2683700,2683750,1249600,1249650,0,3,3,0,3,0,9,0,3,0,3,0,0,6,15
3922,68382483,2683800,2683850,1248300,1248350,0,3,3,3,0,3,12,0,0,3,3,3,0,9,21
3923,68382487,2683800,2683850,1248700,1248750,4,3,0,0,3,3,13,0,0,3,0,0,3,6,19
3924,68382523,2683800,2683850,1252300,1252350,0,3,0,3,3,0,9,3,0,0,0,3,0,6,15
3925,68392507,2683900,2683950,1250700,1250750,3,3,3,0,3,0,12,3,3,3,3,3,0,15,27
3926,68402460,2684000,2684050,1246000,1246050,5,3,3,3,0,0,14,3,3,4,3,3,0,16,30
3927,68402533,2684000,2684050,1253300,1253350,4,0,3,0,0,0,7,3,5,4,0,3,0,15,22
3928,68412459,2684100,2684150,1245900,1245950,0,3,3,0,0,3,9,7,4,3,3,3,3,23,32
3929,68412489,2684100,2684150,1248900,1248950,0,0,3,3,3,0,9,3,3,3,3,3,3,18,27
3930,68412457,2684100,2684150,1245700,1245750,4,3,3,3,3,0,16,3,5,3,3,0,3,17,33
3931,68412525,2684100,2684150,1252500,1252550,0,0,0,0,0,0,0,0,0,0,3,0,0,3,3
3932,68422469,2684200,2684250,1246900,1246950,3,3,3,0,0,0,9,3,3,0,3,3,3,15,24
3933,68422463,2684200,2684250,1246300,1246350,3,3,3,3,0,3,15,3,3,3,3,3,3,18,33
3934,68422502,2684200,2684250,1250200,1250250,3,3,3,0,0,0,9,0,3,0,0,0,0,3,12
3935,68422471,2684200,2684250,1247100,1247150,3,3,3,3,3,0,15,3,3,4,0,0,0,10,25
3936,68422503,2684200,2684250,1250300,1250350,0,0,3,0,0,0,3,3,0,0,0,0,0,3,6
3937,68422538,2684200,2684250,1253800,1253850,3,3,3,0,0,0,9,0,3,3,0,0,0,6,15
3938,68432455,2684300,2684350,1245500,1245550,3,4,3,3,0,3,16,7,8,4,3,0,3,25,41
3939,68432463,2684300,2684350,1246300,1246350,3,0,3,0,0,3,9,0,3,0,0,0,3,6,15
3940,68442479,2684400,2684450,1247900,1247950,3,3,3,8,3,3,23,0,6,5,10,9,4,34,57
3941,68442459,2684400,2684450,1245900,1245950,0,3,0,3,3,0,9,4,3,3,0,3,0,13,22
3942,68442460,2684400,2684450,1246000,1246050,3,3,0,0,0,0,6,0,0,0,0,0,0,0,6
3943,68442526,2684400,2684450,1252600,1252650,0,0,0,0,0,0,0,0,0,3,0,0,0,3,3
3944,68452514,2684500,2684550,1251400,1251450,0,3,0,3,0,0,6,3,3,3,4,3,3,19,25
3945,68452460,2684500,2684550,1246000,1246050,0,3,0,0,0,0,3,0,0,3,0,0,0,3,6
3946,68462460,2684600,2684650,1246000,1246050,8,4,3,3,0,0,18,3,4,3,3,0,0,13,31
3947,68462471,2684600,2684650,1247100,1247150,3,0,0,0,3,0,6,0,0,3,0,0,3,6,12
3948,68472483,2684700,2684750,1248300,1248350,3,3,3,5,3,0,17,3,3,3,3,3,0,15,32
3949,68472464,2684700,2684750,1246400,1246450,3,3,0,0,0,3,9,4,0,3,0,3,0,10,19
3950,68472455,2684700,2684750,1245500,1245550,4,3,3,3,3,0,16,3,4,3,3,3,0,16,32
3951,68472452,2684700,2684750,1245200,1245250,4,5,3,0,0,0,12,3,5,0,3,0,0,11,23
3952,68482466,2684800,2684850,1246600,1246650,3,4,3,0,0,0,10,3,3,3,0,3,0,12,22
3953,68482463,2684800,2684850,1246300,1246350,3,4,3,3,0,0,13,6,3,5,3,3,0,20,33
3954,68482462,2684800,2684850,1246200,1246250,3,3,0,0,0,0,6,4,3,3,0,0,3,13,19
3955,68492476,2684900,2684950,1247600,1247650,0,0,0,0,0,0,0,3,0,0,0,0,0,3,3
3956,68492479,2684900,2684950,1247900,1247950,3,3,3,3,0,0,12,3,3,3,4,0,3,16,28
3957,68502485,2685000,2685050,1248500,1248550,0,0,0,0,0,0,0,0,3,0,0,0,0,3,3
3958,68502480,2685000,2685050,1248000,1248050,3,3,3,3,3,0,15,3,0,3,0,0,0,6,21
3959,68512466,2685100,2685150,1246600,1246650,3,0,3,3,0,0,9,3,3,3,3,3,3,18,27
3960,68512446,2685100,2685150,1244600,1244650,0,3,0,0,3,3,9,4,3,0,0,0,0,7,16
3961,68512449,2685100,2685150,1244900,1244950,5,3,3,3,3,3,20,8,0,3,3,3,3,20,40
3962,68512473,2685100,2685150,1247300,1247350,3,0,3,0,0,0,6,0,0,3,0,0,3,6,12
3963,68512458,2685100,2685150,1245800,1245850,0,0,0,0,0,0,0,3,0,0,0,0,0,3,3
3964,68512508,2685100,2685150,1250800,1250850,4,3,3,3,0,0,13,3,4,3,3,0,0,13,26
3965,68522462,2685200,2685250,1246200,1246250,3,3,3,3,0,0,12,4,3,3,3,3,3,19,31
3966,68522476,2685200,2685250,1247600,1247650,3,0,0,0,0,0,3,0,0,3,0,0,0,3,6
3967,68532473,2685300,2685350,1247300,1247350,3,0,0,0,0,0,3,3,0,0,0,0,0,3,6
3968,68532512,2685300,2685350,1251200,1251250,3,3,3,3,3,0,15,3,3,3,3,3,3,18,33
3969,68532515,2685300,2685350,1251500,1251550,0,3,3,3,3,0,12,3,3,3,3,3,3,18,30
3970,68532460,2685300,2685350,1246000,1246050,5,3,0,3,3,0,14,9,3,6,6,0,3,27,41
3971,68532480,2685300,2685350,1248000,1248050,0,0,0,0,0,0,0,0,3,3,3,3,0,12,12
3972,68532468,2685300,2685350,1246800,1246850,0,0,0,0,0,0,0,0,0,0,0,0,0,0,0
3973,68542470,2685400,2685450,1247000,1247050,0,0,3,0,0,0,3,0,3,0,0,0,0,3,6
3974,68542474,2685400,2685450,1247400,1247450,3,3,0,0,0,0,6,3,3,0,0,0,0,6,12
3975,68542518,2685400,2685450,1251800,1251850,0,0,0,0,0,0,0,0,0,0,0,0,0,0,0
3976,68552512,2685500,2685550,1251200,1251250,4,3,3,3,0,0,13,3,4,3,9,3,3,25,38
3977,68552515,2685500,2685550,1251500,1251550,0,0,3,0,0,0,3,0,3,0,0,0,0,3,6
3978,68562459,2685600,2685650,1245900,1245950,0,0,0,0,0,0,0,3,0,0,0,0,0,3,3
3979,68562458,2685600,2685650,1245800,1245850,3,0,0,0,0,0,3,3,3,0,0,0,3,9,12
3980,68562512,2685600,2685650,1251200,1251250,6,3,3,3,0,0,15,3,3,3,0,0,0,9,24
3981,68572513,2685700,2685750,1251300,1251350,3,0,3,0,0,0,6,3,0,3,0,0,0,6,12
3982,68572463,2685700,2685750,1246300,1246350,0,3,0,0,3,0,6,3,0,0,3,0,0,6,12
3983,68572455,2685700,2685750,1245500,1245550,3,0,3,4,0,0,10,3,3,4,3,3,3,19,29
3984,68572486,2685700,2685750,1248600,1248650,0,0,0,0,0,0,0,0,0,0,0,0,0,0,0
3985,68572459,2685700,2685750,1245900,1245950,3,0,0,0,0,0,3,3,0,0,0,0,0,3,6
3986,68582448,2685800,2685850,1244800,1244850,3,0,3,3,3,0,12,3,3,4,3,0,0,13,25
3987,68582516,2685800,2685850,1251600,1251650,0,0,0,0,0,0,0,0,0,0,0,0,0,0,0
3988,68582490,2685800,2685850,1249000,1249050,0,0,0,0,3,3,6,0,0,0,3,3,0,6,12
3989,68592454,2685900,2685950,1245400,1245450,6,3,0,3,3,0,15,6,3,5,5,0,3,22,37
3990,68592456,2685900,2685950,1245600,1245650,0,0,0,3,0,0,3,0,0,0,3,0,0,3,6
3991,68602462,2686000,2686050,1246200,1246250,0,0,3,0,0,0,3,0,3,3,0,3,0,9,12
3992,68612512,2686100,2686150,1251200,1251250,7,4,3,3,3,3,23,12,7,4,6,5,3,37,60
3993,68612511,2686100,2686150,1251100,1251150,3,3,0,3,0,3,12,5,0,3,3,3,3,17,29
3994,68612454,2686100,2686150,1245400,1245450,0,0,3,0,0,0,3,0,0,3,0,0,0,3,6
3995,68622459,2686200,2686250,1245900,1245950,5,3,3,0,4,3,18,3,5,3,3,3,0,17,35
3996,68642508,2686400,2686450,1250800,1250850,3,3,0,3,0,3,12,3,3,3,3,3,0,15,27
3997,68642502,2686400,2686450,1250200,1250250,0,3,3,0,0,0,6,0,0,3,0,0,3,6,12
3998,68642512,2686400,2686450,1251200,1251250,3,3,0,0,0,0,6,3,3,0,0,0,0,6,12
3999,68652505,2686500,2686550,1250500,1250550,3,3,3,0,0,0,9,0,3,0,3,0,0,6,15
4000,68652514,2686500,2686550,1251400,1251450,3,0,3,0,0,0,6,3,3,3,0,0,0,9,15
4001,68682507,2686800,2686850,1250700,1250750,3,0,3,4,3,0,13,3,0,4,4,3,3,17,30
4002,67822520,2678200,2678250,1252000,1252050,3,0,3,4,0,0,10,3,0,3,0,0,3,9,19
4003,67832491,2678300,2678350,1249100,1249150,3,5,3,0,0,0,11,3,4,5,3,4,3,22,33
4004,67842493,2678400,2678450,1249300,1249350,3,4,3,3,0,0,13,4,3,3,5,3,4,22,35
4005,67842487,2678400,2678450,1248700,1248750,3,0,3,0,0,0,6,3,3,3,0,0,0,9,15
4006,67842485,2678400,2678450,1248500,1248550,3,0,3,3,3,0,12,0,3,3,3,3,3,15,27
4007,67842480,2678400,2678450,1248000,1248050,0,0,3,0,0,0,3,0,3,0,0,0,0,3,6
4008,67862515,2678600,2678650,1251500,1251550,3,3,3,4,3,0,16,3,4,3,5,3,3,21,37
4009,67872482,2678700,2678750,1248200,1248250,3,0,0,0,0,0,3,3,0,0,0,0,0,3,6
4010,67872519,2678700,2678750,1251900,1251950,3,3,3,0,0,0,9,3,3,4,3,0,0,13,22
4011,67872495,2678700,2678750,1249500,1249550,3,0,0,0,0,0,3,0,0,0,0,0,0,0,3
4012,67882469,2678800,2678850,1246900,1246950,0,0,0,0,0,0,0,0,0,0,0,0,0,0,0
4013,67882474,2678800,2678850,1247400,1247450,0,0,3,0,0,0,3,3,0,0,0,0,3,6,9
4014,67892513,2678900,2678950,1251300,1251350,3,0,3,0,0,0,6,3,3,3,0,0,0,9,15
4015,67892491,2678900,2678950,1249100,1249150,3,0,0,3,3,3,12,3,3,0,0,3,3,12,24
4016,67902512,2679000,2679050,1251200,1251250,4,10,3,3,0,0,20,5,6,3,3,3,0,20,40
4017,67912484,2679100,2679150,1248400,1248450,3,3,3,0,0,0,9,0,3,3,0,0,3,9,18
4018,67922488,2679200,2679250,1248800,1248850,0,3,0,3,0,0,6,0,3,0,0,3,0,6,12
4019,67922480,2679200,2679250,1248000,1248050,3,3,3,3,0,0,12,0,3,4,0,0,0,7,19
4020,67932511,2679300,2679350,1251100,1251150,0,3,0,3,3,0,9,5,3,3,3,3,0,17,26
4021,67932476,2679300,2679350,1247600,1247650,3,3,4,3,0,0,13,3,3,3,3,3,0,15,28
4022,67932493,2679300,2679350,1249300,1249350,3,5,6,3,4,3,24,3,3,4,6,3,3,22,46
4023,67932512,2679300,2679350,1251200,1251250,0,3,3,0,0,0,6,3,3,3,0,3,0,12,18
4024,67932486,2679300,2679350,1248600,1248650,0,3,0,0,0,0,3,3,3,0,3,0,0,9,12
4025,67932505,2679300,2679350,1250500,1250550,3,4,4,3,3,0,17,5,4,4,4,3,3,23,40
4026,67932500,2679300,2679350,1250000,1250050,5,8,3,3,0,0,19,9,4,10,3,3,3,32,51
4027,67932535,2679300,2679350,1253500,1253550,0,0,0,0,0,0,0,0,0,0,0,0,0,0,0
4028,67942469,2679400,2679450,1246900,1246950,3,3,3,3,0,0,12,3,3,3,3,3,3,18,30
4029,67942515,2679400,2679450,1251500,1251550,0,0,0,0,0,0,0,0,0,0,0,0,0,0,0
4030,67942535,2679400,2679450,1253500,1253550,0,0,0,0,0,0,0,0,0,0,0,0,0,0,0
4031,67952469,2679500,2679550,1246900,1246950,3,3,3,0,3,0,12,4,3,3,3,3,3,19,31
4032,67952507,2679500,2679550,1250700,1250750,0,0,3,0,0,0,3,0,0,3,0,0,0,3,6
4033,67962504,2679600,2679650,1250400,1250450,5,3,0,0,0,0,8,6,3,0,0,0,0,9,17
4034,67962502,2679600,2679650,1250200,1250250,3,0,0,0,0,0,3,3,0,0,3,0,0,6,9
4035,67972475,2679700,2679750,1247500,1247550,3,3,0,0,0,0,6,0,3,0,3,0,0,6,12
4036,67972471,2679700,2679750,1247100,1247150,4,5,3,3,0,3,18,4,6,3,6,5,3,27,45
4037,67972483,2679700,2679750,1248300,1248350,0,0,0,0,0,0,0,0,0,0,0,0,0,0,0
4038,67972479,2679700,2679750,1247900,1247950,0,0,0,0,0,0,0,0,0,0,0,0,0,0,0
4039,67982485,2679800,2679850,1248500,1248550,3,3,0,0,0,0,6,3,3,0,0,0,3,9,15
4040,67992469,2679900,2679950,1246900,1246950,3,3,0,0,3,0,9,3,3,3,0,3,3,15,24
4041,67992488,2679900,2679950,1248800,1248850,0,3,0,0,0,0,3,3,0,3,3,0,0,9,12
4042,67992458,2679900,2679950,1245800,1245850,0,0,0,0,0,0,0,0,0,0,0,0,0,0,0
4043,68002480,2680000,2680050,1248000,1248050,3,0,0,0,0,0,3,0,0,0,0,0,0,0,3
4044,68002509,2680000,2680050,1250900,1250950,0,3,3,3,3,3,15,3,3,3,0,3,3,15,30
4045,68002532,2680000,2680050,1253200,1253250,7,3,3,3,0,0,16,4,7,3,3,0,3,20,36
4046,68002490,2680000,2680050,1249000,1249050,4,4,3,4,8,9,32,3,8,8,20,13,18,70,102
4047,68002472,2680000,2680050,1247200,1247250,5,0,3,0,3,3,14,3,3,5,3,3,3,20,34
4048,68012470,2680100,2680150,1247000,1247050,3,3,3,0,3,3,15,5,3,5,3,3,3,22,37
4049,68012529,2680100,2680150,1252900,1252950,3,3,3,3,3,0,15,3,5,3,3,3,0,17,32
4050,68012457,2680100,2680150,1245700,1245750,0,0,0,0,0,0,0,0,0,0,0,0,0,0,0
4051,68012524,2680100,2680150,1252400,1252450,3,3,3,0,0,0,9,3,3,3,3,0,0,12,21
4052,68012532,2680100,2680150,1253200,1253250,3,0,0,0,0,0,3,3,3,0,0,3,0,9,12
4053,68022533,2680200,2680250,1253300,1253350,0,0,3,0,0,0,3,0,0,3,0,0,0,3,6
4054,68032523,2680300,2680350,1252300,1252350,0,3,0,3,0,0,6,3,3,0,0,0,0,6,12
4055,68032502,2680300,2680350,1250200,1250250,0,0,3,3,0,0,6,0,3,0,0,0,0,3,9
4056,68042533,2680400,2680450,1253300,1253350,3,3,3,0,0,0,9,3,4,3,0,3,0,13,22
4057,68042518,2680400,2680450,1251800,1251850,0,0,0,0,0,0,0,0,0,0,3,0,0,3,3
4058,68042488,2680400,2680450,1248800,1248850,0,0,0,0,0,0,0,0,0,0,0,0,0,0,0
4059,68052507,2680500,2680550,1250700,1250750,3,3,0,0,0,0,6,3,3,3,0,0,0,9,15
4060,68062501,2680600,2680650,1250100,1250150,3,3,0,3,0,3,12,0,5,3,0,3,3,14,26
4061,68062460,2680600,2680650,1246000,1246050,0,3,3,3,0,3,12,3,3,0,4,0,0,10,22
4062,68072530,2680700,2680750,1253000,1253050,0,0,0,0,0,0,0,0,0,0,0,0,0,0,0
4063,68072471,2680700,2680750,1247100,1247150,3,0,3,3,0,3,12,3,0,7,4,8,5,27,39
4064,68072533,2680700,2680750,1253300,1253350,4,4,0,3,0,0,11,4,3,3,0,0,0,10,21
4065,68082455,2680800,2680850,1245500,1245550,4,3,0,0,0,0,7,3,0,3,3,0,0,9,16
4066,68082495,2680800,2680850,1249500,1249550,0,3,3,0,0,0,6,0,0,0,0,0,0,0,6
4067,68082478,2680800,2680850,1247800,1247850,0,3,3,0,0,0,6,3,3,0,0,0,0,6,12
4068,68082529,2680800,2680850,1252900,1252950,3,0,0,0,3,0,6,3,0,0,3,0,0,6,12
4069,68092453,2680900,2680950,1245300,1245350,3,3,0,3,0,0,9,0,0,4,3,3,3,13,22
4070,68092479,2680900,2680950,1247900,1247950,3,3,3,0,3,0,12,4,0,3,3,3,0,13,25
4071,68092469,2680900,2680950,1246900,1246950,3,5,3,3,3,0,17,4,5,4,4,0,3,20,37
4072,68092497,2680900,2680950,1249700,1249750,3,0,0,0,0,0,3,3,0,0,0,0,0,3,6
4073,68102500,2681000,2681050,1250000,1250050,0,0,3,3,0,0,6,3,3,3,0,0,0,9,15
4074,68102477,2681000,2681050,1247700,1247750,0,3,3,0,0,0,6,0,3,0,0,0,0,3,9
4075,68112500,2681100,2681150,1250000,1250050,0,3,0,3,0,3,9,0,3,3,0,0,0,6,15
4076,68112522,2681100,2681150,1252200,1252250,6,3,6,9,5,3,32,8,6,14,16,12,6,62,94
4077,68122422,2681200,2681250,1242200,1242250,3,3,3,3,3,0,15,3,3,3,4,3,3,19,34
4078,68122478,2681200,2681250,1247800,1247850,3,4,5,0,0,0,12,6,3,3,3,3,3,21,33
4079,68122472,2681200,2681250,1247200,1247250,4,3,3,6,3,0,19,6,5,4,6,3,0,24,43
4080,68122485,2681200,2681250,1248500,1248550,3,0,0,0,0,0,3,0,0,0,0,0,0,0,3
4081,68122421,2681200,2681250,1242100,1242150,5,4,5,3,0,0,17,6,3,5,3,0,0,17,34
4082,68122495,2681200,2681250,1249500,1249550,0,3,0,0,0,0,3,0,0,0,0,0,0,0,3
4083,68132432,2681300,2681350,1243200,1243250,3,0,0,0,0,0,3,0,0,0,0,0,0,0,3
4084,68132459,2681300,2681350,1245900,1245950,3,3,3,3,0,0,12,0,3,3,3,3,0,12,24
4085,68132496,2681300,2681350,1249600,1249650,3,0,0,0,0,0,3,0,0,0,0,0,0,0,3
4086,68142420,2681400,2681450,1242000,1242050,4,5,3,3,3,0,18,4,3,5,0,0,0,12,30
4087,68152471,2681500,2681550,1247100,1247150,6,3,0,0,0,3,12,3,0,3,3,3,0,12,24
4088,68152456,2681500,2681550,1245600,1245650,0,3,3,3,3,0,12,3,3,4,3,3,3,19,31
4089,68162475,2681600,2681650,1247500,1247550,3,0,3,3,0,0,9,3,3,0,0,3,3,12,21
4090,68162481,2681600,2681650,1248100,1248150,3,0,0,0,0,0,3,0,3,0,3,3,0,9,12
4091,68162437,2681600,2681650,1243700,1243750,0,0,0,0,0,0,0,0,0,0,0,0,0,0,0
4092,68162498,2681600,2681650,1249800,1249850,3,3,0,0,3,0,9,3,6,3,3,3,0,18,27
4093,68172470,2681700,2681750,1247000,1247050,3,3,3,3,0,3,15,3,6,6,0,3,0,18,33
4094,68172459,2681700,2681750,1245900,1245950,0,0,0,0,0,3,3,0,0,0,0,3,0,3,6
4095,68172488,2681700,2681750,1248800,1248850,5,3,0,0,3,0,11,6,4,3,3,3,3,22,33
4096,68192518,2681900,2681950,1251800,1251850,3,5,3,3,0,0,14,3,0,3,3,0,0,9,23
4097,68202436,2682000,2682050,1243600,1243650,3,3,3,3,0,0,12,3,4,3,4,3,3,20,32
4098,68202472,2682000,2682050,1247200,1247250,3,3,3,3,0,0,12,3,3,3,3,3,0,15,27
4099,68202466,2682000,2682050,1246600,1246650,0,0,0,0,0,0,0,0,0,0,0,0,0,0,0
4100,68202457,2682000,2682050,1245700,1245750,3,0,3,3,0,3,12,3,3,3,3,3,3,18,30
4101,68202444,2682000,2682050,1244400,1244450,0,0,0,0,0,0,0,0,0,0,0,0,0,0,0
4102,68212472,2682100,2682150,1247200,1247250,3,3,0,0,0,0,6,6,3,3,3,3,0,18,24
4103,68212456,2682100,2682150,1245600,1245650,7,3,3,0,3,0,16,4,3,3,0,3,0,13,29
4104,68212523,2682100,2682150,1252300,1252350,0,3,3,3,0,0,9,0,3,3,0,3,0,9,18
4105,68212461,2682100,2682150,1246100,1246150,3,3,0,0,0,0,6,0,3,0,0,0,0,3,9
4106,68222444,2682200,2682250,1244400,1244450,3,3,3,3,0,3,15,4,3,3,3,3,3,19,34
4107,68222440,2682200,2682250,1244000,1244050,3,0,3,3,3,0,12,0,0,3,0,0,3,6,18
4108,68222479,2682200,2682250,1247900,1247950,3,0,3,3,0,0,9,3,3,3,0,0,0,9,18
4109,68222449,2682200,2682250,1244900,1244950,0,0,0,0,0,3,3,0,3,3,0,3,0,9,12
4110,68232475,2682300,2682350,1247500,1247550,0,0,0,0,0,0,0,0,0,0,0,0,0,0,0
4111,68232444,2682300,2682350,1244400,1244450,0,3,3,5,3,6,20,3,3,3,6,22,37,74,94
4112,68232500,2682300,2682350,1250000,1250050,3,3,0,0,0,0,6,3,0,0,0,3,0,6,12
4113,68232515,2682300,2682350,1251500,1251550,0,0,0,3,0,0,3,3,0,3,3,0,0,9,12
4114,68232456,2682300,2682350,1245600,1245650,0,3,3,3,0,0,9,0,0,0,3,0,0,3,12
4115,68232447,2682300,2682350,1244700,1244750,3,3,3,3,0,0,12,3,3,0,0,0,0,6,18
4116,68242449,2682400,2682450,1244900,1244950,3,0,3,3,0,0,9,3,3,0,3,3,3,15,24
4117,68242495,2682400,2682450,1249500,1249550,6,3,3,3,0,0,15,4,3,3,3,0,3,16,31
4118,68242441,2682400,2682450,1244100,1244150,3,4,3,3,0,3,16,5,3,0,3,3,0,14,30
4119,68242432,2682400,2682450,1243200,1243250,3,3,3,0,0,0,9,3,3,0,3,0,0,9,18
4120,68242490,2682400,2682450,1249000,1249050,0,3,9,5,6,3,26,3,3,9,7,13,26,61,87
4121,68242512,2682400,2682450,1251200,1251250,3,3,3,3,3,0,15,4,4,5,3,0,0,16,31
4122,68242463,2682400,2682450,1246300,1246350,0,0,0,0,0,0,0,0,0,0,0,0,0,0,0
4123,68252442,2682500,2682550,1244200,1244250,3,3,0,0,3,0,9,6,3,3,3,3,3,21,30
4124,68252496,2682500,2682550,1249600,1249650,3,3,3,0,3,0,12,3,5,3,5,3,0,19,31
4125,68252522,2682500,2682550,1252200,1252250,3,0,0,0,3,0,6,3,0,0,3,0,0,6,12
4126,68252468,2682500,2682550,1246800,1246850,0,3,0,0,0,0,3,0,0,0,0,0,0,0,3
4127,68252527,2682500,2682550,1252700,1252750,0,0,0,0,0,0,0,0,0,0,0,0,0,0,0
4128,68262518,2682600,2682650,1251800,1251850,3,3,0,0,0,0,6,3,3,3,0,0,0,9,15
4129,68262446,2682600,2682650,1244600,1244650,3,0,3,3,3,0,12,3,3,3,3,3,0,15,27
4130,68262454,2682600,2682650,1245400,1245450,0,0,0,0,3,3,6,0,0,0,0,0,3,3,9
4131,68272432,2682700,2682750,1243200,1243250,3,3,3,3,0,0,12,4,3,3,5,3,0,18,30
4132,68272431,2682700,2682750,1243100,1243150,3,3,3,0,0,3,12,4,5,3,3,0,0,15,27
4133,68272508,2682700,2682750,1250800,1250850,0,0,0,0,0,0,0,0,3,0,0,0,0,3,3
4134,68272502,2682700,2682750,1250200,1250250,0,3,3,0,3,3,12,3,3,3,3,4,3,19,31
4135,68272467,2682700,2682750,1246700,1246750,0,0,3,0,0,0,3,3,0,0,3,0,0,6,9
4136,68272532,2682700,2682750,1253200,1253250,3,3,3,0,0,0,9,3,0,0,0,0,0,3,12
4137,68282501,2682800,2682850,1250100,1250150,0,0,0,3,0,0,3,3,3,3,0,0,0,9,12
4138,68292477,2682900,2682950,1247700,1247750,0,3,3,0,0,0,6,0,3,3,0,0,0,6,12
4139,68292508,2682900,2682950,1250800,1250850,3,3,0,0,0,3,9,0,3,3,0,3,3,12,21
4140,68292522,2682900,2682950,1252200,1252250,3,4,0,3,3,0,13,3,4,3,3,0,0,13,26
4141,68292431,2682900,2682950,1243100,1243150,3,3,3,0,0,3,12,3,3,3,3,3,3,18,30
4142,68292465,2682900,2682950,1246500,1246550,3,3,0,0,3,0,9,0,0,3,0,0,3,6,15
4143,68292489,2682900,2682950,1248900,1248950,0,0,0,0,0,3,3,3,0,3,0,0,0,6,9
4144,68302493,2683000,2683050,1249300,1249350,3,5,3,0,3,3,17,4,3,3,0,3,3,16,33
4145,68302531,2683000,2683050,1253100,1253150,3,4,0,3,3,3,16,3,3,3,3,3,3,18,34
4146,68302502,2683000,2683050,1250200,1250250,4,0,3,3,3,0,13,0,3,3,3,3,3,15,28
4147,68302469,2683000,2683050,1246900,1246950,0,3,0,0,0,0,3,0,3,3,0,0,0,6,9
4148,68302470,2683000,2683050,1247000,1247050,0,0,0,0,0,0,0,0,0,0,0,0,0,0,0
4149,68312505,2683100,2683150,1250500,1250550,3,4,0,0,0,0,7,3,3,3,3,0,0,12,19
4150,68312500,2683100,2683150,1250000,1250050,3,0,3,0,0,0,6,0,3,0,0,3,0,6,12
4151,68312532,2683100,2683150,1253200,1253250,3,3,0,0,3,3,12,3,3,3,3,3,0,15,27
4152,68312511,2683100,2683150,1251100,1251150,3,3,3,3,0,0,12,3,0,0,3,0,0,6,18
4153,68312468,2683100,2683150,1246800,1246850,0,0,0,0,0,0,0,0,0,0,0,0,0,0,0
4154,68322529,2683200,2683250,1252900,1252950,4,6,8,4,3,4,29,11,9,7,8,5,3,43,72
4155,68322528,2683200,2683250,1252800,1252850,3,3,3,0,0,0,9,3,0,3,0,0,0,6,15
4156,68322433,2683200,2683250,1243300,1243350,0,0,0,0,0,0,0,0,0,0,0,0,0,0,0
4157,68322536,2683200,2683250,1253600,1253650,3,3,3,3,0,0,12,3,4,3,0,3,0,13,25
4158,68322497,2683200,2683250,1249700,1249750,6,3,3,3,3,0,18,4,3,5,8,3,0,23,41
4159,68322527,2683200,2683250,1252700,1252750,0,0,0,0,0,0,0,0,0,0,0,0,0,0,0
4160,68322530,2683200,2683250,1253000,1253050,3,0,0,3,0,0,6,3,3,3,0,0,0,9,15
4161,68322485,2683200,2683250,1248500,1248550,0,0,0,0,0,0,0,0,3,3,0,0,0,6,6
4162,68322476,2683200,2683250,1247600,1247650,0,0,0,0,0,0,0,0,0,0,0,0,0,0,0
4163,68332495,2683300,2683350,1249500,1249550,6,0,0,0,0,0,6,3,3,3,3,3,0,15,21
4164,68332506,2683300,2683350,1250600,1250650,3,3,3,3,3,3,18,4,3,3,3,0,0,13,31
4165,68342539,2683400,2683450,1253900,1253950,0,3,0,0,0,0,3,0,3,0,0,0,0,3,6
4166,68342488,2683400,2683450,1248800,1248850,4,3,3,0,0,0,10,5,3,3,3,0,3,17,27
4167,68342508,2683400,2683450,1250800,1250850,4,3,3,3,3,3,19,3,3,3,5,3,3,20,39
4168,68342478,2683400,2683450,1247800,1247850,3,0,3,0,0,0,6,3,0,0,3,3,0,9,15
4169,68352492,2683500,2683550,1249200,1249250,3,3,3,3,0,0,12,4,3,4,3,0,0,14,26
4170,68362526,2683600,2683650,1252600,1252650,3,3,0,0,0,0,6,3,3,0,3,3,0,12,18
4171,68362490,2683600,2683650,1249000,1249050,3,0,0,0,3,0,6,0,0,3,3,3,0,9,15
4172,68372524,2683700,2683750,1252400,1252450,4,3,3,3,0,0,13,3,3,3,3,0,0,12,25
4173,68372495,2683700,2683750,1249500,1249550,0,0,3,3,0,0,6,3,3,3,0,0,3,12,18
4174,68372526,2683700,2683750,1252600,1252650,0,3,0,0,0,0,3,0,3,0,0,0,0,3,6
4175,68382459,2683800,2683850,1245900,1245950,3,3,0,0,0,0,6,3,4,3,3,0,0,13,19
4176,68392506,2683900,2683950,1250600,1250650,0,3,0,0,0,0,3,0,0,3,0,0,0,3,6
4177,68392459,2683900,2683950,1245900,1245950,3,3,0,4,0,0,10,0,0,3,0,0,3,6,16
4178,68392484,2683900,2683950,1248400,1248450,0,3,4,3,3,0,13,3,5,3,3,3,0,17,30
4179,68392532,2683900,2683950,1253200,1253250,5,4,4,3,3,0,19,4,3,7,3,3,3,23,42
4180,68392492,2683900,2683950,1249200,1249250,3,3,3,3,3,0,15,3,3,3,3,0,0,12,27
4181,68392495,2683900,2683950,1249500,1249550,3,0,3,0,0,0,6,0,3,0,3,0,3,9,15
4182,68392468,2683900,2683950,1246800,1246850,0,0,3,0,0,0,3,0,0,0,0,0,0,0,3
4183,68392469,2683900,2683950,1246900,1246950,3,3,0,0,0,0,6,3,0,0,0,0,0,3,9
4184,68402526,2684000,2684050,1252600,1252650,0,0,0,0,0,0,0,0,0,0,0,0,0,0,0
4185,68412464,2684100,2684150,1246400,1246450,3,3,3,3,0,3,15,3,3,3,0,3,3,15,30
4186,68412501,2684100,2684150,1250100,1250150,0,3,3,0,0,0,6,0,3,0,0,0,0,3,9
4187,68412532,2684100,2684150,1253200,1253250,0,0,3,3,0,0,6,3,0,0,0,0,0,3,9
4188,68412454,2684100,2684150,1245400,1245450,0,0,0,0,0,0,0,0,0,0,0,3,0,3,3
4189,68422506,2684200,2684250,1250600,1250650,3,3,3,0,0,0,9,3,3,3,3,3,3,18,27
4190,68422507,2684200,2684250,1250700,1250750,3,3,3,3,3,0,15,3,3,3,0,3,3,15,30
4191,68422475,2684200,2684250,1247500,1247550,3,3,3,0,0,0,9,3,3,3,0,3,0,12,21
4192,68422488,2684200,2684250,1248800,1248850,3,3,3,3,3,0,15,3,3,3,0,3,0,12,27
4193,68422518,2684200,2684250,1251800,1251850,3,3,0,0,0,0,6,0,0,0,0,0,0,0,6
4194,68432510,2684300,2684350,1251000,1251050,3,3,0,0,0,0,6,0,0,3,0,0,0,3,9
4195,68432472,2684300,2684350,1247200,1247250,6,0,3,0,0,0,9,3,3,3,0,3,3,15,24
4196,68442478,2684400,2684450,1247800,1247850,3,3,0,3,3,0,12,3,3,0,3,3,3,15,27
4197,68452509,2684500,2684550,1250900,1250950,3,3,6,3,3,0,18,4,6,3,5,3,3,24,42
4198,68452489,2684500,2684550,1248900,1248950,0,0,3,0,0,3,6,0,3,3,0,0,3,9,15
4199,68462467,2684600,2684650,1246700,1246750,3,3,3,3,3,0,15,4,3,3,3,3,0,16,31
4200,68462473,2684600,2684650,1247300,1247350,3,3,3,0,0,0,9,3,3,0,3,3,0,12,21
4201,68462487,2684600,2684650,1248700,1248750,0,0,0,0,3,0,3,0,3,0,3,3,0,9,12
4202,68472481,2684700,2684750,1248100,1248150,0,3,3,0,3,0,9,0,3,3,3,3,0,12,21
4203,68482513,2684800,2684850,1251300,1251350,0,3,0,0,0,0,3,3,0,0,0,0,0,3,6
4204,68482451,2684800,2684850,1245100,1245150,3,3,0,0,0,0,6,3,3,0,0,0,0,6,12
4205,68492480,2684900,2684950,1248000,1248050,3,3,3,3,3,0,15,3,3,4,3,3,3,19,34
4206,68502513,2685000,2685050,1251300,1251350,0,0,0,0,3,0,3,0,0,0,3,0,0,3,6
4207,68502453,2685000,2685050,1245300,1245350,3,0,0,0,0,0,3,3,0,3,0,3,0,9,12
4208,68502511,2685000,2685050,1251100,1251150,4,0,0,0,0,0,4,3,3,3,3,0,0,12,16
4209,68502478,2685000,2685050,1247800,1247850,3,0,3,0,3,0,9,3,3,3,3,3,0,15,24
4210,68502447,2685000,2685050,1244700,1244750,3,0,3,0,0,0,6,3,0,0,0,0,0,3,9
4211,68512481,2685100,2685150,1248100,1248150,3,4,3,3,0,0,13,4,0,3,0,0,0,7,20
4212,68512479,2685100,2685150,1247900,1247950,3,0,3,0,0,0,6,3,3,3,3,0,0,12,18
4213,68522460,2685200,2685250,1246000,1246050,5,3,3,3,3,0,17,3,4,8,3,3,3,24,41
4214,68522520,2685200,2685250,1252000,1252050,4,3,3,3,0,0,13,3,4,3,0,0,0,10,23
4215,68532446,2685300,2685350,1244600,1244650,3,0,3,0,0,0,6,3,3,3,3,0,0,12,18
4216,68542484,2685400,2685450,1248400,1248450,0,0,0,0,0,0,0,0,0,3,0,0,0,3,3
4217,68542480,2685400,2685450,1248000,1248050,0,0,0,0,0,0,0,0,0,0,0,0,0,0,0
4218,68552459,2685500,2685550,1245900,1245950,0,3,3,0,3,3,12,0,3,3,0,3,3,12,24
4219,68552463,2685500,2685550,1246300,1246350,3,3,3,0,3,0,12,3,0,3,3,0,0,9,21
4220,68552466,2685500,2685550,1246600,1246650,0,0,0,0,3,0,3,0,0,3,0,0,0,3,6
4221,68562465,2685600,2685650,1246500,1246550,6,3,3,0,0,0,12,3,0,3,0,0,0,6,18
4222,68562462,2685600,2685650,1246200,1246250,0,3,0,0,0,0,3,0,0,0,0,0,0,0,3
4223,68572456,2685700,2685750,1245600,1245650,3,0,3,3,0,0,9,4,3,4,3,0,0,14,23
4224,68572458,2685700,2685750,1245800,1245850,0,0,3,0,0,3,6,3,0,3,3,3,0,12,18
4225,68572516,2685700,2685750,1251600,1251650,3,3,0,0,0,0,6,3,3,3,0,0,0,9,15
4226,68572509,2685700,2685750,1250900,1250950,3,3,0,3,0,3,12,0,0,3,3,6,5,17,29
4227,68582508,2685800,2685850,1250800,1250850,3,0,3,0,3,0,9,3,0,3,3,3,3,15,24
4228,68602449,2686000,2686050,1244900,1244950,0,3,3,0,3,0,9,0,3,3,3,3,0,12,21
4229,68602457,2686000,2686050,1245700,1245750,3,0,3,0,0,0,6,0,3,0,0,0,0,3,9
4230,68632502,2686300,2686350,1250200,1250250,3,0,3,0,0,0,6,3,3,0,3,3,0,12,18
4231,68632462,2686300,2686350,1246200,1246250,3,0,0,0,0,0,3,3,0,0,0,0,0,3,6
4232,68632505,2686300,2686350,1250500,1250550,3,0,0,0,0,0,3,3,3,0,3,0,0,9,12
4233,68652506,2686500,2686550,1250600,1250650,3,3,0,0,0,0,6,3,4,3,3,0,0,13,19
4234,68652512,2686500,2686550,1251200,1251250,3,3,3,3,0,0,12,3,4,3,0,0,3,13,25
4235,68662458,2686600,2686650,1245800,1245850,3,3,3,3,0,3,15,3,3,3,3,3,0,15,30
4236,68662457,2686600,2686650,1245700,1245750,0,0,3,3,0,0,6,3,3,3,0,0,0,9,15
4237,68662461,2686600,2686650,1246100,1246150,4,4,4,4,3,3,22,7,3,3,5,3,3,24,46
4238,68662460,2686600,2686650,1246000,1246050,3,3,3,3,3,3,18,3,4,3,5,3,3,21,39
4239,68672458,2686700,2686750,1245800,1245850,0,0,0,0,0,0,0,0,0,0,0,0,0,0,0
4240,68682503,2686800,2686850,1250300,1250350,3,0,3,0,3,0,9,3,3,0,0,3,0,9,18
4241,68702503,2687000,2687050,1250300,1250350,4,3,0,3,0,0,10,3,3,3,0,3,0,12,22
4242,68702510,2687000,2687050,1251000,1251050,0,0,0,0,0,0,0,0,0,3,0,0,0,3,3
4243,68712460,2687100,2687150,1246000,1246050,0,0,0,0,3,3,6,0,3,3,3,0,0,9,15
4244,68722483,2687200,2687250,1248300,1248350,0,0,0,0,0,0,0,0,3,0,0,0,0,3,3
4245,68752456,2687500,2687550,1245600,1245650,0,0,0,0,0,0,0,0,0,0,0,0,0,0,0
4246,68762459,2687600,2687650,1245900,1245950,3,3,0,3,0,0,9,3,3,0,3,3,3,15,24
4247,68792456,2687900,2687950,1245600,1245650,4,3,3,3,3,3,19,3,5,5,4,0,0,17,36
4248,68692465,2686900,2686950,1246500,1246550,0,0,0,0,0,0,0,0,0,0,0,0,0,0,0
4249,68702512,2687000,2687050,1251200,1251250,3,0,3,3,0,0,9,3,3,0,3,0,0,9,18
4250,68712461,2687100,2687150,1246100,1246150,3,3,3,4,6,0,19,4,0,6,4,4,3,21,40
4251,68722511,2687200,2687250,1251100,1251150,0,0,0,0,0,0,0,3,0,0,0,0,0,3,3
4252,68732458,2687300,2687350,1245800,1245850,3,3,0,3,0,0,9,3,3,3,0,3,0,12,21
4253,68742459,2687400,2687450,1245900,1245950,3,0,0,0,0,0,3,3,0,3,0,0,3,9,12
4254,68742460,2687400,2687450,1246000,1246050,3,3,3,3,0,0,12,3,3,4,3,3,3,19,31
4255,68742457,2687400,2687450,1245700,1245750,5,3,0,0,0,0,8,3,0,0,3,0,0,6,14
4256,68792455,2687900,2687950,1245500,1245550,0,0,3,0,0,0,3,0,3,0,0,0,0,3,6
4257,67792490,2677900,2677950,1249000,1249050,3,3,0,3,3,0,12,0,3,3,3,0,0,9,21
4258,67802488,2678000,2678050,1248800,1248850,0,0,0,0,0,0,0,0,0,0,0,0,0,0,0
4259,67832487,2678300,2678350,1248700,1248750,3,3,0,3,0,0,9,0,3,3,0,3,0,9,18
4260,67832486,2678300,2678350,1248600,1248650,3,0,0,0,0,0,3,3,3,0,0,0,0,6,9
4261,67852493,2678500,2678550,1249300,1249350,0,3,3,0,0,0,6,0,4,0,0,3,0,7,13
4262,67852490,2678500,2678550,1249000,1249050,3,0,3,3,3,0,12,3,0,3,3,3,0,12,24
4263,67852522,2678500,2678550,1252200,1252250,5,0,5,3,0,0,13,3,5,3,3,4,0,18,31
4264,67852484,2678500,2678550,1248400,1248450,0,3,3,3,0,3,12,3,0,0,3,3,0,9,21
4265,67852488,2678500,2678550,1248800,1248850,0,3,0,3,3,0,9,3,3,0,3,3,3,15,24
4266,67862488,2678600,2678650,1248800,1248850,3,0,5,3,3,0,14,3,3,3,3,3,0,15,29
4267,67862486,2678600,2678650,1248600,1248650,0,0,3,3,3,0,9,0,0,0,5,0,0,5,14
4268,67872509,2678700,2678750,1250900,1250950,3,3,3,3,0,0,12,3,3,4,3,3,0,16,28
4269,67872518,2678700,2678750,1251800,1251850,3,3,3,3,3,0,15,5,3,5,3,0,3,19,34
4270,67882510,2678800,2678850,1251000,1251050,6,4,3,3,0,0,16,3,8,5,3,4,3,26,42
4271,67882519,2678800,2678850,1251900,1251950,0,0,0,0,0,0,0,0,3,0,0,3,3,9,9
4272,67882489,2678800,2678850,1248900,1248950,0,0,3,0,4,0,7,3,3,3,3,3,0,15,22
4273,67882513,2678800,2678850,1251300,1251350,0,0,3,3,0,0,6,3,3,0,3,0,0,9,15
4274,67882516,2678800,2678850,1251600,1251650,3,0,3,3,0,3,12,3,5,4,3,3,3,21,33
4275,67892475,2678900,2678950,1247500,1247550,3,3,0,3,3,0,12,0,3,3,0,0,0,6,18
4276,67902511,2679000,2679050,1251100,1251150,3,3,3,3,3,3,18,3,3,3,3,0,0,12,30
4277,67902493,2679000,2679050,1249300,1249350,3,3,3,0,0,0,9,0,0,3,4,3,0,10,19
4278,67902506,2679000,2679050,1250600,1250650,0,0,0,0,0,0,0,0,0,0,0,0,0,0,0
4279,67912493,2679100,2679150,1249300,1249350,5,7,6,3,0,3,24,11,8,3,3,3,3,31,55
4280,67912512,2679100,2679150,1251200,1251250,3,3,3,3,0,3,15,5,3,3,3,4,0,18,33
4281,67922472,2679200,2679250,1247200,1247250,4,0,0,3,0,0,7,3,3,3,0,3,0,12,19
4282,67922491,2679200,2679250,1249100,1249150,3,3,3,0,0,0,9,3,3,3,3,0,0,12,21
4283,67932485,2679300,2679350,1248500,1248550,3,3,0,0,0,0,6,3,0,3,3,0,0,9,15
4284,67942467,2679400,2679450,1246700,1246750,3,3,3,3,3,0,15,3,3,0,3,0,3,12,27
4285,67942480,2679400,2679450,1248000,1248050,0,3,3,0,0,3,9,3,3,3,0,0,0,9,18
4286,67942500,2679400,2679450,1250000,1250050,3,7,3,4,3,0,20,8,3,8,3,0,0,22,42
4287,67942499,2679400,2679450,1249900,1249950,8,12,8,7,4,3,42,7,11,16,8,7,5,54,96
4288,67952504,2679500,2679550,1250400,1250450,3,3,3,0,0,0,9,3,3,3,3,0,0,12,21
4289,67952496,2679500,2679550,1249600,1249650,0,0,0,0,0,0,0,3,0,0,0,0,0,3,3
4290,67952513,2679500,2679550,1251300,1251350,3,3,0,0,0,0,6,3,3,3,0,0,0,9,15
4291,67952465,2679500,2679550,1246500,1246550,3,0,0,0,0,0,3,3,3,0,0,0,0,6,9
4292,67962509,2679600,2679650,1250900,1250950,3,3,3,0,3,0,12,3,4,3,3,3,0,16,28
4293,67962480,2679600,2679650,1248000,1248050,3,3,3,0,3,0,12,3,3,3,0,0,0,9,21
4294,67962467,2679600,2679650,1246700,1246750,3,3,3,3,0,0,12,3,3,3,3,0,0,12,24
4295,67972507,2679700,2679750,1250700,1250750,3,3,0,0,0,0,6,3,3,0,3,3,0,12,18
4296,67972489,2679700,2679750,1248900,1248950,3,5,3,3,0,0,14,3,4,0,3,0,0,10,24
4297,67982510,2679800,2679850,1251000,1251050,3,6,3,3,0,0,15,3,3,10,3,4,3,26,41
4298,67982474,2679800,2679850,1247400,1247450,4,0,3,3,0,0,10,3,4,0,0,3,0,10,20
4299,67982524,2679800,2679850,1252400,1252450,0,0,0,0,0,0,0,0,0,0,0,0,0,0,0
4300,67982492,2679800,2679850,1249200,1249250,0,0,0,0,0,0,0,0,0,0,0,0,0,0,0
4301,67982486,2679800,2679850,1248600,1248650,0,0,0,0,0,0,0,0,0,0,0,0,0,0,0
4302,67992511,2679900,2679950,1251100,1251150,3,3,0,3,3,0,12,0,3,3,3,3,0,12,24
4303,67992480,2679900,2679950,1248000,1248050,0,0,0,0,0,0,0,0,0,3,0,0,0,3,3
4304,68002506,2680000,2680050,1250600,1250650,3,3,3,3,0,0,12,4,0,3,3,3,0,13,25
4305,68002464,2680000,2680050,1246400,1246450,3,3,3,3,0,0,12,0,3,3,3,3,0,12,24
4306,68012510,2680100,2680150,1251000,1251050,0,3,3,3,3,3,15,3,3,8,3,4,3,24,39
4307,68012474,2680100,2680150,1247400,1247450,0,0,3,0,0,3,6,0,3,3,3,0,3,12,18
4308,68022481,2680200,2680250,1248100,1248150,3,3,3,0,3,3,15,0,0,0,3,3,0,6,21
4309,68022529,2680200,2680250,1252900,1252950,3,3,3,3,3,0,15,5,3,3,3,3,0,17,32
4310,68022467,2680200,2680250,1246700,1246750,10,11,3,4,0,3,31,11,8,7,7,3,3,39,70
4311,68022490,2680200,2680250,1249000,1249050,0,0,0,0,0,0,0,0,0,0,0,3,0,3,3
4312,68022468,2680200,2680250,1246800,1246850,3,4,5,3,3,0,18,7,9,4,6,4,6,36,54
4313,68022451,2680200,2680250,1245100,1245150,0,0,0,0,0,0,0,0,0,0,0,0,0,0,0
4314,68032461,2680300,2680350,1246100,1246150,5,4,3,6,9,3,30,7,8,8,5,7,5,40,70
4315,68032483,2680300,2680350,1248300,1248350,3,6,0,0,0,3,12,3,3,3,3,0,0,12,24
4316,68032501,2680300,2680350,1250100,1250150,3,3,3,3,3,0,15,3,4,3,0,3,0,13,28
4317,68032503,2680300,2680350,1250300,1250350,3,4,3,0,0,0,10,3,5,0,0,0,0,8,18
4318,68032460,2680300,2680350,1246000,1246050,3,3,3,0,0,0,9,4,3,0,0,3,3,13,22
4319,68032500,2680300,2680350,1250000,1250050,0,3,3,0,0,0,6,3,3,3,0,0,0,9,15
4320,68042509,2680400,2680450,1250900,1250950,0,3,3,0,0,0,6,3,3,3,3,0,0,12,18
4321,68042460,2680400,2680450,1246000,1246050,0,3,3,3,3,3,15,4,3,3,3,3,3,19,34
4322,68052533,2680500,2680550,1253300,1253350,3,0,0,0,0,0,3,0,0,0,0,0,0,0,3
4323,68052480,2680500,2680550,1248000,1248050,3,3,3,0,0,0,9,6,4,0,3,0,0,13,22
4324,68052532,2680500,2680550,1253200,1253250,0,0,3,3,3,0,9,0,0,3,0,0,0,3,12
4325,68052501,2680500,2680550,1250100,1250150,3,3,0,0,3,0,9,3,0,3,3,3,0,12,21
4326,68052471,2680500,2680550,1247100,1247150,3,3,0,0,0,0,6,3,0,3,0,3,3,12,18
4327,68052497,2680500,2680550,1249700,1249750,0,0,0,0,0,0,0,0,0,0,0,0,0,0,0
4328,68052508,2680500,2680550,1250800,1250850,0,0,0,0,0,0,0,0,0,0,0,0,0,0,0
4329,68062503,2680600,2680650,1250300,1250350,3,3,3,0,0,0,9,0,0,3,0,0,3,6,15
4330,68062534,2680600,2680650,1253400,1253450,3,0,3,3,0,0,9,0,3,0,0,0,0,3,12
4331,68062474,2680600,2680650,1247400,1247450,3,0,0,0,0,0,3,3,0,0,3,0,0,6,9
4332,68062529,2680600,2680650,1252900,1252950,3,3,5,3,3,0,17,6,7,10,7,4,3,37,54
4333,68062522,2680600,2680650,1252200,1252250,4,3,0,3,3,0,13,3,4,4,3,3,3,20,33
4334,68062517,2680600,2680650,1251700,1251750,0,3,0,0,0,0,3,3,3,3,0,0,0,9,12
4335,68062456,2680600,2680650,1245600,1245650,0,0,3,0,0,0,3,0,0,0,3,0,0,3,6
4336,68082470,2680800,2680850,1247000,1247050,3,3,3,3,0,3,15,3,3,3,3,3,3,18,33
4337,68082458,2680800,2680850,1245800,1245850,3,4,3,6,4,3,23,4,10,5,4,8,6,37,60
4338,68082468,2680800,2680850,1246800,1246850,3,3,3,0,0,0,9,0,3,3,0,3,0,9,18
4339,68082484,2680800,2680850,1248400,1248450,5,6,3,4,4,3,25,7,3,4,9,9,13,45,70
4340,68092500,2680900,2680950,1250000,1250050,0,0,0,0,3,3,6,0,3,3,0,0,0,6,12
4341,68102529,2681000,2681050,1252900,1252950,0,3,0,0,3,0,6,3,0,0,0,0,0,3,9
4342,68102493,2681000,2681050,1249300,1249350,0,0,3,0,0,0,3,3,0,3,0,0,0,6,9
4343,68102474,2681000,2681050,1247400,1247450,4,4,3,0,0,0,11,3,3,3,3,3,3,18,29
4344,68112483,2681100,2681150,1248300,1248350,3,0,3,0,3,0,9,0,3,3,3,0,0,9,18
4345,68112467,2681100,2681150,1246700,1246750,3,3,3,3,0,0,12,3,3,3,3,3,0,15,27
4346,68112517,2681100,2681150,1251700,1251750,4,3,3,0,0,0,10,3,3,3,3,3,0,15,25
4347,68112475,2681100,2681150,1247500,1247550,3,3,3,0,0,0,9,0,0,0,0,3,3,6,15
4348,68112461,2681100,2681150,1246100,1246150,0,0,0,0,0,0,0,0,0,0,0,0,0,0,0
4349,68122499,2681200,2681250,1249900,1249950,3,3,3,3,0,0,12,4,5,7,3,0,0,19,31
4350,68122476,2681200,2681250,1247600,1247650,5,3,4,0,0,0,12,6,7,3,3,0,0,19,31
4351,68122484,2681200,2681250,1248400,1248450,5,3,3,3,3,0,17,5,3,3,4,0,3,18,35
4352,68122424,2681200,2681250,1242400,1242450,0,0,0,0,0,0,0,0,0,0,0,0,0,0,0
4353,68122426,2681200,2681250,1242600,1242650,4,3,3,0,3,3,16,3,3,3,3,3,3,18,34
4354,68122504,2681200,2681250,1250400,1250450,0,0,0,0,0,0,0,0,0,0,0,0,0,0,0
4355,68122430,2681200,2681250,1243000,1243050,3,0,4,3,3,0,13,3,3,3,3,3,0,15,28
4356,68132471,2681300,2681350,1247100,1247150,3,3,0,3,3,0,12,3,3,3,0,3,0,12,24
4357,68132480,2681300,2681350,1248000,1248050,8,4,3,3,3,3,24,4,6,4,3,4,3,24,48
4358,68132479,2681300,2681350,1247900,1247950,3,3,3,0,3,0,12,3,3,0,3,0,0,9,21
4359,68132466,2681300,2681350,1246600,1246650,0,3,0,3,0,0,6,0,3,3,0,0,0,6,12
4360,68132463,2681300,2681350,1246300,1246350,0,0,0,0,0,0,0,0,0,0,0,0,0,0,0
4361,68142522,2681400,2681450,1252200,1252250,0,0,3,0,0,3,6,0,3,3,3,3,0,12,18
4362,68142459,2681400,2681450,1245900,1245950,3,0,3,3,0,0,9,3,3,3,0,0,0,9,18
4363,68142435,2681400,2681450,1243500,1243550,3,3,3,0,3,3,15,3,3,3,3,3,3,18,33
4364,68142425,2681400,2681450,1242500,1242550,3,3,3,0,0,0,9,3,3,3,3,0,0,12,21
4365,68142460,2681400,2681450,1246000,1246050,3,0,0,3,0,0,6,0,3,3,0,3,0,9,15
4366,68152433,2681500,2681550,1243300,1243350,0,0,0,0,0,0,0,3,3,0,3,0,3,12,12
4367,68152460,2681500,2681550,1246000,1246050,3,0,0,3,0,3,9,3,3,0,0,3,0,9,18
4368,68152478,2681500,2681550,1247800,1247850,3,8,3,3,3,0,20,8,4,3,0,3,3,21,41
4369,68152429,2681500,2681550,1242900,1242950,0,0,0,0,0,0,0,0,0,0,0,0,3,3,3
4370,68152537,2681500,2681550,1253700,1253750,0,0,0,0,0,0,0,0,0,0,0,0,0,0,0
4371,68162462,2681600,2681650,1246200,1246250,0,0,0,0,0,0,0,0,0,0,3,0,0,3,3
4372,68172468,2681700,2681750,1246800,1246850,10,3,3,3,0,0,19,4,8,3,3,0,3,21,40
4373,68172517,2681700,2681750,1251700,1251750,0,3,3,0,3,0,9,3,3,0,3,3,0,12,21
4374,68172492,2681700,2681750,1249200,1249250,0,3,3,0,0,0,6,3,3,3,0,0,0,9,15
4375,68182492,2681800,2681850,1249200,1249250,3,0,3,3,0,0,9,3,0,3,0,0,0,6,15
4376,68182462,2681800,2681850,1246200,1246250,4,0,0,0,0,0,4,3,0,3,0,0,0,6,10
4377,68192460,2681900,2681950,1246000,1246050,0,0,0,0,3,0,3,0,0,0,0,0,0,0,3
4378,68202499,2682000,2682050,1249900,1249950,4,0,0,0,3,0,7,3,3,3,0,3,0,12,19
4379,68202458,2682000,2682050,1245800,1245850,3,0,0,0,0,0,3,0,3,0,3,0,0,6,9
4380,68202487,2682000,2682050,1248700,1248750,5,3,3,0,0,0,11,3,3,0,0,0,0,6,17
4381,68202527,2682000,2682050,1252700,1252750,0,0,0,0,0,0,0,0,0,0,0,3,0,3,3
4382,68212435,2682100,2682150,1243500,1243550,3,3,3,0,3,0,12,5,4,4,3,3,3,22,34
4383,68212451,2682100,2682150,1245100,1245150,0,3,3,0,0,0,6,3,3,0,0,0,0,6,12
4384,68222480,2682200,2682250,1248000,1248050,9,5,4,0,0,0,18,3,3,3,0,0,0,9,27
4385,68222435,2682200,2682250,1243500,1243550,0,0,3,3,0,0,6,3,3,3,0,0,0,9,15
4386,68222490,2682200,2682250,1249000,1249050,3,0,0,0,0,0,3,3,3,0,0,0,0,6,9
4387,68222437,2682200,2682250,1243700,1243750,4,0,3,3,0,0,10,3,3,3,3,3,0,15,25
4388,68222445,2682200,2682250,1244500,1244550,3,0,0,3,3,0,9,4,3,3,0,0,0,10,19
4389,68222489,2682200,2682250,1248900,1248950,5,5,3,3,3,0,19,3,5,3,0,3,0,14,33
4390,68222436,2682200,2682250,1243600,1243650,0,3,0,3,0,3,9,0,3,6,3,3,3,18,27
4391,68222448,2682200,2682250,1244800,1244850,0,3,0,0,0,3,6,0,0,0,3,0,3,6,12
4392,68222514,2682200,2682250,1251400,1251450,3,0,0,0,0,0,3,0,3,0,0,0,0,3,6
4393,68232452,2682300,2682350,1245200,1245250,3,0,3,3,3,3,15,3,0,4,0,0,0,7,22
4394,68232442,2682300,2682350,1244200,1244250,3,3,3,0,3,0,12,3,3,0,4,3,0,13,25
4395,68232485,2682300,2682350,1248500,1248550,4,5,0,3,0,0,12,3,3,3,0,0,3,12,24
4396,68232491,2682300,2682350,1249100,1249150,3,4,4,3,0,0,14,3,3,3,0,0,3,12,26
4397,68232472,2682300,2682350,1247200,1247250,0,3,3,0,0,0,6,3,0,3,3,0,3,12,18
4398,68232495,2682300,2682350,1249500,1249550,3,3,3,3,0,0,12,3,3,3,3,0,0,12,24
4399,68242500,2682400,2682450,1250000,1250050,3,6,0,0,0,0,9,3,6,3,3,0,0,15,24
4400,68242516,2682400,2682450,1251600,1251650,3,3,3,0,0,0,9,3,3,3,0,0,0,9,18
4401,68252514,2682500,2682550,1251400,1251450,3,0,0,3,3,0,9,3,0,3,3,3,0,12,21
4402,68252459,2682500,2682550,1245900,1245950,0,3,0,3,0,0,6,0,3,3,0,0,0,6,12
4403,68252452,2682500,2682550,1245200,1245250,0,0,0,3,0,0,3,0,0,0,3,0,0,3,6
4404,68252461,2682500,2682550,1246100,1246150,0,0,3,0,0,0,3,0,3,0,0,0,0,3,6
4405,68252446,2682500,2682550,1244600,1244650,3,3,3,0,0,0,9,3,3,3,3,0,0,12,21
4406,68252458,2682500,2682550,1245800,1245850,0,0,3,0,0,0,3,0,0,0,0,0,0,0,3
4407,68262504,2682600,2682650,1250400,1250450,0,0,3,0,0,0,3,3,3,3,3,3,3,18,21
4408,68262468,2682600,2682650,1246800,1246850,3,3,3,0,0,0,9,3,3,3,3,0,0,12,21
4409,68262462,2682600,2682650,1246200,1246250,3,3,3,0,0,3,12,3,3,3,3,0,3,15,27
4410,68262443,2682600,2682650,1244300,1244350,3,7,3,3,0,3,19,4,5,3,0,0,3,15,34
4411,68262502,2682600,2682650,1250200,1250250,3,3,0,0,0,0,6,3,0,0,3,0,0,6,12
4412,68262464,2682600,2682650,1246400,1246450,3,0,3,3,3,3,15,3,4,3,3,3,0,16,31
4413,68262469,2682600,2682650,1246900,1246950,0,0,3,0,3,0,6,3,3,3,0,0,0,9,15
4414,68262481,2682600,2682650,1248100,1248150,0,3,3,3,0,0,9,3,3,0,0,0,0,6,15
4415,68262492,2682600,2682650,1249200,1249250,0,0,3,0,0,0,3,0,0,0,0,0,0,0,3
4416,68262514,2682600,2682650,1251400,1251450,0,0,0,0,0,0,0,0,0,0,0,0,0,0,0
4417,68272483,2682700,2682750,1248300,1248350,0,0,0,0,0,0,0,0,3,3,3,0,3,12,12
4418,68272515,2682700,2682750,1251500,1251550,5,3,0,3,0,3,14,3,3,3,0,3,0,12,26
4419,68272436,2682700,2682750,1243600,1243650,0,0,0,0,3,0,3,0,0,3,0,0,3,6,9
4420,68272435,2682700,2682750,1243500,1243550,0,0,3,3,3,0,9,0,0,3,3,3,0,9,18
4421,68272429,2682700,2682750,1242900,1242950,0,0,0,0,0,0,0,0,0,0,0,0,0,0,0
4422,68282500,2682800,2682850,1250000,1250050,3,3,3,3,0,3,15,3,7,0,3,0,0,13,28
4423,68282466,2682800,2682850,1246600,1246650,3,0,3,3,3,0,12,3,3,3,3,3,0,15,27
4424,68292429,2682900,2682950,1242900,1242950,3,0,3,3,3,0,12,3,3,3,3,3,3,18,30
4425,68292533,2682900,2682950,1253300,1253350,3,6,3,3,5,3,23,5,6,5,8,5,5,34,57
4426,68292526,2682900,2682950,1252600,1252650,3,5,3,0,0,0,11,3,3,3,3,3,3,18,29
4427,68292469,2682900,2682950,1246900,1246950,0,0,3,0,0,0,3,0,0,0,0,0,0,0,3
4428,68292490,2682900,2682950,1249000,1249050,3,3,6,3,3,0,18,3,5,4,5,0,4,21,39
4429,68292428,2682900,2682950,1242800,1242850,3,3,3,3,3,3,18,3,3,4,3,0,0,13,31
4430,68292457,2682900,2682950,1245700,1245750,0,0,0,0,0,0,0,0,0,0,0,0,0,0,0
4431,68302515,2683000,2683050,1251500,1251550,3,3,0,0,0,0,6,3,3,3,3,0,3,15,21
4432,68302503,2683000,2683050,1250300,1250350,3,0,3,0,0,0,6,3,3,3,0,0,0,9,15
4433,68302501,2683000,2683050,1250100,1250150,3,0,3,3,0,0,9,3,3,0,3,0,0,9,18
4434,68302537,2683000,2683050,1253700,1253750,7,4,7,4,3,3,28,3,6,10,4,4,3,30,58
4435,68152520,2681500,2681550,1252000,1252050,0,0,0,0,0,0,0,0,3,0,0,0,0,3,3
